'S	  qq ee s 
10%	  t s e: n qq   p r o: t s ee n t 
128	  h uu n d ei t a x t   uu n t t s v a n t s ii cc qq 
14	  f i: r t s e: n qq 
15	  f yy n f t s e: n qq 
18	  a x t t s e: n qq 
186	  h uu n d ei t z ee k s   uu n t a x t t s ii cc qq 
1949	  t au z @ n t qq n oy n h uu n d ei t n oy n   uu n t f i: r t s ii cc qq 
1977	  t au z @ n t qq n oy n h uu n d ei t z i: b @ n   uu n t z i: b t s ii cc qq 
1983	  t au z @ n t qq n oy n h uu n d ei t d r ai   uu n t a x t t s ii cc qq 
1998	  t au z @ n t qq n oy n h uu n d ei t a x t   uu n t n oy n t s ii cc qq 
2%	  t s v ai qq   p r o: t s ee n t 
20	  t s v a n t s ii cc qq 
2000	  t s v ai t au z @ n t qq qq 
2002	  t s v ai t au z @ n t qq t s v ai qq 
2004	  t s v ai t au z @ n t qq f i: r qq 
2005	  t s v ai t au z @ n t qq f yy n f qq 
21	  ai n   uu n t t s v a n t s ii cc qq 
24	  f i: r   uu n t t s v a n t s ii cc qq 
242	  t s v ai h uu n d ei t t s v ai   uu n t f i: r t s ii cc qq 
25	  f yy n f   uu n t t s v a n t s ii cc qq 
253	  t s v ai h uu n d ei t d r ai   uu n t f yy n f t s ii cc qq 
254	  t s v ai h uu n d ei t f i: r   uu n t f yy n f t s ii cc qq 
328	  d r ai h uu n d ei t a x t   uu n t t s v a n t s ii cc qq 
4	  f i: r qq 
40%	  f i: r t s ii cc qq   p r o: t s ee n t 
43	  d r ai   uu n t f i: r t s ii cc qq 
500000	  f yy n f h uu n d ei t t au z @ n t qq 
75	  f yy n f   uu n t z i: b t s ii cc qq 
80	  a x t t s ii cc qq 
80%	  a x t t s ii cc qq   p r o: t s ee n t 
850	  a x t h uu n d ei t f yy n f t s ii cc qq 
90	  n oy n t s ii cc qq 
90°_NEUNZIG_GRAD	  n oy n t s ii cc qq   n oy n t s ii cc   g r aa: t 
99	  n oy n   uu n t n oy n t s ii cc qq 
A	  qq aa: 
AB	  qq a p 
ABBEDINGUNG	  qq a p b @ d ii nn uu nn 
ABEGTEILT	  qq a b ee g t ai l t 
ABER	  qq aa: b ei 
ABFOLGE	  qq a p f oo l g @ 
ABGEDECKT	  qq a p g @ d ee k t 
ABGEGEBEN	  qq a p g @ g e: b @ n 
ABGEHEN	  qq a p g e: @ n 
ABGEHT	  qq a p g e: t 
ABGELAUFEN	  qq a p g @ l au f @ n 
ABGELEITET	  qq a p g @ l ai t @ t 
ABGELEITETEN	  qq a p g @ l ai t qq e: t @ n 
ABGENUTZT	  qq a p g @ n uu t s t 
ABGESCHAFFT	  qq a p g @ ss a f t 
ABGESCHLIFFEN	  qq a p g @ ss l ii f @ n 
ABGESCHLOSSEN	  qq a p g @ ss l oo s @ n 
ABHäNGIG	  qq qq a p   h ee:   nn i: k 
ABHöRSICHER	  qq qq a p   h ui:   qq r z ii cc ei 
ABKüRZUNGEN	  qq qq a p   k y:   qq r t s uu nn @ n 
ABLAUF	  qq a p l au f 
ABSCHLIEßEN	  qq a p ss l i:   qq e: s   qq e: n 
ABSCHLIEßENDE	  qq a p ss l i:   qq e: s   qq ee n d @ 
ABSCHLIEßT	  qq a p ss l i:   qq e: s   t e: 
ABSCHLUSSFREIHEIT	  qq a p ss l uu s f r ai h ai t 
ABSCHLUß	  qq a b ss l   qq u: s 
ABSCHRECKEN	  qq a p ss r ee k @ n 
ABSENDERADRESSE	  qq a p z @ n d e: r a d r ee s @ 
ABSENDERS	  qq a p z @ n d ei s 
ABSOLUT	  qq a p z o: l u: t 
ABSOLUTEN	  qq a p z o: l u: t @ n 
ABSOLUTES	  qq a p z o: l u: t @ s 
ABSTAND	  qq a p ss t a n t 
ABSTEHEN	  qq a p ss t e: @ n 
ABSTEHENDE	  qq a p ss t e: @ n d @ 
ABSTEHT	  qq a p ss t e: t 
ABZUGEBEN	  qq a p t s u: g e: b @ n 
ABZUGRENZEN	  qq a p t s u: g r ee n t s @ n 
ABZUSCHLIEßEN	  qq a p t s u: ss l i:   qq e: s   qq e: n 
ACCESS	  a k s ee s 
ACH	  qq a x 
ACHSBOHRUNG	  qq a k s b o: r uu nn 
ACHT	  qq a x t 
ADRESSAT	  qq a d r ee s aa: t 
ADRESSATEN	  qq a d r ee s aa: t @ n 
ADRESSE	  qq a d r @ s @ 
ADRESSEN	  qq a d r @ s @ n 
ADRESSRAUM	  qq a d r ee s r au m 
ADRESSZUWEISUNG	  qq a d r ee s t s u: v ai z uu nn 
AES	  qq ee: s 
AGGRESSIVE	  qq a g r ee s i: v @ 
AKKUS	  qq a k uu s 
AKT	  qq a k t 
AKTIV	  qq a k t i: f 
AKTIVEN	  qq a k t i: v @ n 
AKTIVISTEN	  qq a k t i: v ii s t @ n 
AKTUELLE	  qq a k t u: ee l @ 
AKTUELLEN	  qq a k t u: ee l @ n 
ALGORITHMUS	  qq a l g o: r ii t m uu s 
ALKOHOLISIERT	  qq a l k o: o: l i: z i: r t 
ALLE	  qq a l @ 
ALLEN	  qq a l @ n 
ALLER	  qq a l ei 
ALLERDINGS	  qq a l ei d ii nn s 
ALLES	  qq a l @ s 
ALLGEMEIN	  qq a l g e: m ai n 
ALLGEMEINE	  qq a l g e: m ai n @ 
ALLGEMEINEN	  qq a l g e: m ai n @ n 
ALLGEMEINES	  qq a l g e: m ai n @ s 
ALLGEMEINHEIT	  qq a l g e: m ai n h ai t 
ALS	  qq aa: l s 
ALSO	  qq a l z o: 
ALSO_DAS_TEIL	  qq a l z o:   d a s   t ai l 
ALTER	  qq a l t ei 
ALTERNATIVE	  qq a l t ei n a t i: v @ 
ALTERNATIVEN	  qq a l t ei n a t i: v @ n 
AM	  qq a m 
AMTS	  qq a m t s 
AN	  qq a n 
ANALOG	  qq a n a l o: k 
ANALOGE	  qq a n a l o: g @ 
ANALOGIE	  qq a n a l o: g i: 
ANALYSIERT	  qq a n a l y: z i: r t 
ANBAHNUNG	  qq a n b aa: n uu nn 
ANBIETER	  qq a n b i: t ei 
ANBIETERN	  qq a n b i: t @ r n 
ANBINDUNG	  qq a n b ii n d uu nn 
ANDERE	  qq a n d @ r @ 
ANDEREM	  qq a n d @ r @ m 
ANDEREN	  qq a n d @ r @ n 
ANDERER	  qq a n d @ r ei 
ANDERES	  qq a n d @ r @ s 
ANDERS	  qq a n d ei s 
ANERKANNT	  qq a n qq ee r k a n t 
ANERKANNTE	  qq a n qq ee r k a n t @ 
ANFRAGE	  qq a n f r aa: g @ 
ANFRAGEN	  qq a n f r aa: g @ n 
ANGABE	  qq a n g aa: b @ 
ANGABEN	  qq a n g aa: b @ n 
ANGEBLICH	  qq a n g e: b l ii cc 
ANGEBOT	  qq a n g @ b o: t 
ANGEBRACHT	  qq a n g @ b r a x t 
ANGEBUNDEN	  qq a n g @ b uu n d @ n 
ANGEFORDERT	  qq a n g @ f oo r d @ r t 
ANGEGEBEN	  qq a n g @ g e: b @ n 
ANGEGRIFFEN	  qq a n g @ g r ii f @ n 
ANGEHäUFT	  qq a nn @   h ee:   qq uu f t 
ANGEKLAGT	  qq a n g @ k l aa: k t 
ANGEKOMMEN	  qq a n g @ k oo m @ n 
ANGELEGENHEIT	  qq a n g @ l e: g @ n h ai t 
ANGEMESSENEN	  qq a n g @ m ee s @ n @ n 
ANGERUFEN	  qq a n g @ qq r u: f @ n 
ANGESCHLOSSEN	  qq a n g @ ss l oo s @ n 
ANGESEHEN	  qq a n g @ z e: @ n 
ANGESETZT	  qq a n g @ z ee t s t 
ANGESTRENGTES	  qq a n g @ ss t r ee nn t @ s 
ANGEWENDET	  qq a n g @ v ee n d @ t 
ANGEZEIGT	  qq a n g @ t s ai k t 
ANGREIFER	  qq a n g r ai f ei 
ANGREIFERN	  qq a n g r ai f @ r n 
ANGRENZEN	  qq a n g r ee n t s @ n 
ANGRENZEND	  qq a n g r ee n t s @ n t 
ANGRENZENDEN	  qq a n g r ee n t s @ n d @ n 
ANGRENZT	  qq a n g r ee n t s t 
ANGRIFFS	  qq a n g r ii f s 
ANGUCKEN	  qq a n g uu k @ n 
ANGUCKT	  qq a n g uu k t 
ANHäUFUNG	  qq qq a n   h ee:   qq u: f uu nn 
ANKLAGE	  qq a n k l aa: g @ 
ANLEITUNG	  qq a n l ai t qq uu nn 
ANLIEGEN	  qq a n l i: g @ n 
ANLIEGT	  qq a n l i: k t 
ANMERKUNGEN	  qq a n m ee r k uu nn @ n 
ANONYMITäT	  qq a n qq o: n y: m i:   t ee:   t e: 
ANS	  qq a n s 
ANSCHAUEN	  qq a n ss au @ n 
ANSCHAUT	  qq a n ss au t 
ANSCHEIN	  qq a n ss ai n 
ANSCHLAG	  qq a n ss l aa: k 
ANSCHLIEßEND	  qq a n ss l i:   qq e: s   qq ee n t 
ANSCHLIEßT	  qq a n ss l i:   qq e: s   t e: 
ANSCHLUSS	  qq a n ss l uu s 
ANSONSTEN	  qq a n z o: n s t @ n 
ANSPRUCH	  qq a n ss p r uu x 
ANSPRüCHE	  qq a n s p   qq r y:   cc e: 
ANSPRüCHEN	  qq a n s p   qq r y:   cc e: n 
ANSSCHLIEßT	  qq a n s cc l i:   qq e: s   t e: 
ANTRAG	  qq a n t r aa: k 
ANTRAGSBERECHTIGT	  qq a n t r a g s b e: r ee cc t ii cc t 
ANTRAGSTELLER	  qq a n t r a g s t ee l ei 
ANTRAGSTELLERS	  qq a n t r a g s t ee l ei s 
ANTWORTEN	  qq a n t v oo r t @ n 
ANVERTRAUT	  qq a n f ee r t r au t 
ANWENDBAR	  qq a n v ee n d b aa: r 
ANWENDUNG	  qq a n v ee n d uu nn 
ANWENDUNGEN	  qq a n v ee n d uu nn @ n 
ANZEIGEPFLICHT	  qq a n t s ai g ee p f l ii cc t 
ANZUBRINGEN	  qq a n t s u: b r ii nn @ n 
ANZUTREFFEN	  qq a n t s u: t r ee f @ n 
ARBEIT	  qq a r b ai t 
ARBEITEN	  qq a r b ai t @ n 
ARBEITET	  qq a r b ai t @ t 
ARBEITGEBER	  qq a r b ai t g e: b ei 
ARBEITGEBERVERBAND	  qq a r b ai t g e: b ee r v ei b a n t 
ARBEITGEBERVERBäNDE	  qq a r b ai t g e: b @ r v ei   b ee:   n d e: 
ARBEITSFäHIGKEIT	  qq a r b ai t s   f ee:   h ii cc k ai t 
ARBEITSRECHT	  qq a r b ai t s r ee cc t 
ARBEITSVERHäLTNISSES	  qq a r b ai t s v ei   h ee:   l t n ii s @ s 
ARCHITEKTUR	  qq a r cc i: t ee k t u: r 
ARGLISTEINREDE	  qq a r g l ii s t ai n r e: d @ 
ART	  qq a r t 
ARTIKEL	  qq a r t i: k @ l 
ASYMMETRISCHES	  qq a z yy m ee t r ii ss @ s 
ATLANTIKKüSTE	  qq a t l a n t i: k   k y:   ss t e: 
ATTRAKTIV	  qq a t r a k t i: f 
AUCH	  qq au x 
AUDIO	  qq au d ii o: 
AUF	  qq au f 
AUFGEBAUT	  qq au f g @ b au t 
AUFGEGEBEN	  qq au f g @ g e: b @ n 
AUFGEHOLT	  qq au f g @ h oo l t 
AUFGELöST	  qq au f g @   l ui:   qq ee s t e: 
AUFGESPIELT	  qq au f g @ ss p i: l t 
AUFGETEILT	  qq au f g @ t ai l t 
AUFGRUND	  qq au f g r uu n t 
AUFHEBUNGSFREIHEIT	  qq au f h e: b uu nn s f r ai h ai t 
AUFHöRT	  qq au f   h ui:   qq ee r t e: 
AUFLAGEN	  qq au f l aa: g @ n 
AUFLIEGT	  qq au f l i: k t 
AUFLöSENDE	  qq au f   l ui:   z ee n d @ 
AUFNAHME	  qq au f n aa: m @ 
AUFRECHTERHALTUNG	  qq au f qq r ee cc t ei h a l t uu nn 
AUFTRETEN	  qq au f t r e: t @ n 
AUFTRETENDE	  qq au f t r e: t @ n d @ 
AUFZUBAUEN	  qq au f t s u: b au @ n 
AUFZUHöREN	  qq qq au f t s u:   h ui:   qq ee r @ n 
AUS	  qq au s 
AUSBREITEN	  qq au s b r ai t @ n 
AUSBUCHTUNG	  qq au s b uu x t uu nn 
AUSDRUCK	  qq au s d r uu k 
AUSDRüCKE	  qq au s t   qq r y:   k e: 
AUSDRüCKLICH	  qq au s t   qq r y:   k l ii cc 
AUSFLUSS	  qq au s f l uu s 
AUSFüLLEN	  qq qq au s   f y:   l e: n 
AUSFüLLT	  qq qq au s   f y:   qq ee l ee l t e: 
AUSGEFüLLT	  qq au s g @   f y:   qq ee l ee l t e: 
AUSGEFüLLTE	  qq au s g @   f y:   l t e: 
AUSGEGANGEN	  qq au s g @ g a nn @ n 
AUSGEGLICHEN	  qq au s g @ g l ii cc @ n 
AUSGELEGT	  qq au s g @ l e: k t 
AUSGENUTZT	  qq au s g @ n uu t s t 
AUSGESCHLOSSEN	  qq au s g @ ss l oo s @ n 
AUSGESCHöPFT	  qq au s g ee s k   h ui:   p e: ee f t e: 
AUSGESEHEN	  qq au s g @ z e: @ n 
AUSGESETZT	  qq au s g @ z ee t s t 
AUSGESPARTEN	  qq au s g @ ss p a r t @ n 
AUSGESPROCHEN	  qq au s g @ ss p r oo x @ n 
AUSGESTALTET	  qq au s g @ ss t a l t @ t 
AUSGESTATTET	  qq au s g @ ss t a t @ t 
AUSGESTRAHLT	  qq au s g @ ss t r aa: l t 
AUSGETAUSCHT	  qq au s g @ t au ss t 
AUSLAND	  qq au s l a n t 
AUSLEGUNG	  qq au s l e: g uu nn 
AUSLäNDER	  qq qq au s   l ee:   n d e: r 
AUSLäNDISCHEM	  qq qq au s   l ee:   n d ii ss @ m 
AUSLäNDISCHES	  qq qq au s   l ee:   n d ii ss @ s 
AUSLäUFER	  qq qq au s   l ee:   qq u: f ei 
AUSLäUFT	  qq qq au s   l ee:   qq uu f t 
AUSNAHMEN	  qq au s n aa: m @ n 
AUSNAHMSWEISE	  qq au s n aa: m s v ai z @ 
AUSPRäGUNG	  qq au s p   qq r ee:   g uu nn 
AUSREDE	  qq au s r e: d @ 
AUSREICHEND	  qq au s qq r ai cc @ n t 
AUSSAGEN	  qq au s z aa: g @ n 
AUSSAH	  qq au s z aa: 
AUSSCHAUT	  qq au s ss au t 
AUSSCHLAGGEBEND	  qq au s ss l aa: k g e: b @ n t 
AUSSCHLIEßLICH	  qq au s ss l i:   qq e: s   l ii cc 
AUSSEHEN	  qq au s z e: @ n 
AUSSEN	  qq au s @ n 
AUSSENKANTE	  qq au s z ee n k a n t @ 
AUSSER	  qq au s ei 
AUSSIEHT	  qq au s z i: t 
AUSTAUSCH	  qq au s t au ss 
AUSTRITT	  qq au s t r ii t 
AUSWAHLFELD	  qq au s v aa: l f ee l t 
AUSWAHLFELDES	  qq au s v aa: l f ee l d @ s 
AUSWUCHTUNG	  qq au s v uu x t uu nn 
AUSZUGEHEN	  qq au s t s u: g e: @ n 
AUSZUSCHöPFEN	  qq au s t s uu s k   h ui:   p f e: n 
AUTHENTIFIZIERUNG	  qq au t ee n t i: f i: t s i: r uu nn 
AUTHENTIFZIEREN	  qq au t ee n t ii f t s i: r @ n 
AUTORISIERTE	  qq au t o: r i: z i: r t @ 
AUßEN	  qq aa:   qq u: s   qq e: n 
AUßERDEM	  qq aa:   qq u: s   qq ee r d e: m 
AUßERHALB	  qq aa:   qq u: s   qq ee r h a l p 
AXIOME	  qq a k s ii o: m @ 
BALKEN	  b a l k @ n 
BANDBREITE	  b a n d b r ai t @ 
BANDBREITENVERBRAUCH	  b a n d b r ai t ee n v ei b r au x 
BANDENMäßIG	  b a n d @ n   m ee: s   qq i: k 
BASIERT	  b a z i: r t 
BATTERIELEBENSDAUER	  b a t e: r i: l e: b ee n s d au ei 
BAUARTEN	  b au a r t @ n 
BAUCH	  b au x 
BAUCHDECKE	  b au x d ee k @ 
BAUCHLINIE	  b au x l i: n i: 
BAUCHRAUMES	  b au x r au m @ s 
BAUKäSTEN	  b au   k ee:   ss t e: n 
BAULAND	  b au l a n t 
BAUSTEIN	  b au s t ai n 
BAUSTEINE	  b au s t ai n @ 
BAUSTEINEN	  b au s t ai n @ n 
BAUSTEINES	  b au s t ai n @ s 
BAUSTEINKOMPLEX	  b au s t ai n k oo m p l ee k s 
BEACHTEN	  b @ qq a x t @ n 
BEACHTET	  b @ qq a x t @ t 
BEANSPRUCHT	  b @ qq a n ss p r uu x t 
BEBAUUNGSPLAN	  b @ b au uu nn s p l aa: n 
BEDARF	  b @ d a r f 
BEDEUTET	  b @ d oy t @ t 
BEDEUTUNGEN	  b @ d oy t uu nn @ n 
BEDINGUNG	  b @ d ii nn uu nn 
BEEINFLUSST	  b @ qq ai n f l uu s t 
BEEINTRäCHTIGT	  b @ qq ai n t   qq r ee:   cc t ii cc t 
BEEINTRäCHTIGUNG	  b @ qq ai n t   qq r ee:   cc t ii g uu nn 
BEENDET	  b @ qq ee n d @ t 
BEFANDEN	  b @ f a n d @ n 
BEFEHLE	  b @ f e: l @ 
BEFESTIGEN	  b @ f ee s t qq i: g @ n 
BEFESTIGT	  b @ f ee s t qq ii cc t 
BEFESTIGUNGSPUNKTEN	  b @ f ee s t qq ii g uu nn s p uu nn k t @ n 
BEFINDEN	  b @ f ii n d @ n 
BEFINDET	  b @ f ii n d @ t 
BEFINDLICHEN	  b @ f ii n d l ii cc @ n 
BEFOLGEN	  b @ f oo l g @ n 
BEFRIEDETEN	  b @ f r i: d @ t @ n 
BEGANGEN	  b @ g a nn @ n 
BEGANGENE	  b @ g a nn @ n @ 
BEGINNT	  b @ g ii n t 
BEGRENZT	  b @ g r ee n t s t 
BEGRIFF	  b @ g r ii f 
BEGRüNDEN	  b e: k   qq r y:   n d e: n 
BEGRüNDET	  b e: k   qq r y:   n d e: t 
BEGRüNDETHEIT	  b e: k   qq r y:   n d ee t h ai t 
BEGüNSTIGEN	  b e:   g y:   n s t i: g @ n 
BEHANDELN	  b @ h a n d @ l n 
BEHAUPTETE	  b @ h au p t @ t @ 
BEHERRSCHEN	  b @ h ee r ss @ n 
BEHINDERT	  b @ h ii n d @ r t 
BEHöRDE	  b e:   h ui:   qq r d e: 
BEI	  b ai 
BEIDE	  b ai d @ 
BEIDEN	  b ai d @ n 
BEIDER	  b ai d ei 
BEIM	  b ai m 
BEIN	  b ai qq ee n 
BEINE	  b ai n @ 
BEINEN	  b ai n @ n 
BEINES	  b ai n @ s 
BEINHALTET	  b ai n h a l t @ t 
BEISPIELE	  b ai ss p i: l @ 
BEISPIELSWEISE	  b ai ss p i: l s v ai z @ 
BEJAHEN	  b @ j aa: @ n 
BEKANNT	  b @ k a n t 
BEKOMMT	  b @ k oo m t 
BELASTENDE	  b @ l a s t @ n d @ 
BELASTET	  b @ l a s t @ t 
BELIEBIGE	  b @ l i: b ii g @ 
BELIEBT	  b @ l i: p t 
BELIEBTER	  b @ l i: b t ei 
BENACHBARTEN	  b @ n a x b a r t @ n 
BENACHTEILIGT	  b @ n a x t ai l ii cc t 
BENUTZEN	  b @ n uu t s @ n 
BENUTZER	  b @ n uu t s ei 
BENUTZERFREUNDLICH	  b @ n uu t s ei f r oy n d l ii cc 
BENUTZERNAME	  b @ n uu t s ei n aa: m @ 
BENUTZUNG	  b @ n uu t s uu nn 
BENöTIGT	  b e:   n ui:   t ii cc t 
BEOBACHTER	  b @ o: b a x t ei 
BERATER	  b @ qq r aa: t ei 
BERECHNET	  b @ qq r ee cc n @ t 
BERECHTIGT	  b @ qq r ee cc t ii cc t 
BEREICH	  b @ qq r ai cc 
BEREICHE	  b @ qq r ai cc @ 
BEREICHERUNGSEINREDE	  b @ qq r ai cc e: r uu nn s qq ai n r e: d @ 
BEREITS	  b @ qq r ai t s 
BERIEF	  b @ qq r i: f 
BERLIN	  b ee r l i: n 
BERN	  b ee r n 
BERüCKSICHTIGEN	  b e:   qq r y:   k s ii cc t ii g @ n 
BERüCKSICHTIGT	  b e:   qq r y:   k s ii cc t ii cc t 
BERüHERN	  b e:   qq r y:   h ee r n 
BERüHREN	  b e:   qq r y:   h ee r @ n 
BERüHRT	  b e:   qq r y:   h aa: ee r t e: 
BERüHRUNG	  b e:   qq r y:   h r uu nn 
BESCHLEUNIGT	  b @ ss l oy n ii cc t 
BESCHREIBE	  b @ ss r ai b @ 
BESCHREIBEN	  b @ ss r ai b @ n 
BESCHREIBUNG	  b @ ss r ai b uu nn 
BESCHRIEBEN	  b @ ss r i: b @ n 
BESCHRäNKBAR	  b ee ss   qq r ee:   nn k b aa: r 
BESCHRäNKT	  b ee ss   qq r ee:   qq ee n k aa: t e: 
BESCHULDIGTEN	  b @ ss uu l d ii cc t @ n 
BESCHWERDEFüHRER	  b @ ss v e: r d @   f y:   h ee r ei 
BESCHWERDEFüHRERIN	  b @ ss v e: r d @   f y:   h r e: r ii n 
BESCHWERDEFüHRERS	  b @ ss v e: r d @   f y:   h r ei s 
BESCHWERDESCHRIFT	  b @ ss v e: r d ee ss r ii f t 
BESIEDELT	  b @ z i: d @ l t 
BESITZERIN	  b @ z ii t s @ r ii n 
BESITZT	  b @ z ii t s t 
BESONDERS	  b @ z oo n d ei s 
BESSER	  b ee s ei 
BESSERE	  b ee s @ r @ 
BESSERER	  b ee s @ r ei 
BESTAND	  b @ ss t a n t 
BESTANDTEIL	  b @ ss t a n t ai l 
BESTANDTEILE	  b @ ss t a n t ai l @ 
BESTEHEN	  b @ ss t e: @ n 
BESTEHENDE	  b @ ss t e: @ n d @ 
BESTEHT	  b @ ss t e: t 
BESTIMMT	  b @ ss t ii m t 
BESTIMMTE	  b @ ss t ii m t @ 
BESTIMMTEN	  b @ ss t ii m t @ n 
BESTRAFT	  b @ ss t r a f t 
BESTäNDIG	  b e: s   t ee:   n d i: k 
BESUCHEN	  b @ z u: x @ n 
BESUCHER	  b @ z u: x ei 
BETEILIGTENFäHIGKEIT	  b @ t ai l ii cc t @ n   f ee:   h ii cc k ai t 
BETRACHT	  b @ t r a x t 
BETRACHTE	  b @ t r a x t @ 
BETRACHTEN	  b @ t r a x t @ n 
BETRACHTET	  b @ t r a x t @ t 
BETRAGEN	  b @ t r aa: g @ n 
BETREFFEN	  b @ t r ee f @ n 
BETRIEB	  b @ t r i: p 
BETRIEBS	  b @ t r i: b s 
BETRIEBSGEHEIMNIS	  b @ t r i: b s g e: ai m n ii s 
BETRIEBSKOSTEN	  b @ t r i: b s k oo s t @ n 
BETRIEBSSYSTEM	  b @ t r i: b s yy s t @ m 
BETRIEBSSYSTEMEN	  b @ t r i: b s yy s t e: m @ n 
BETROFFEN	  b @ t r oo f @ n 
BETRUG	  b @ t r u: k 
BETäTIGEN	  b e:   t ee:   t i: g @ n 
BETäTIGT	  b e:   t ee:   t ii cc t 
BEVOR	  b e: f o: r 
BEVORZUGTE	  b @ f o: r t s u: k t @ 
BEVöLKERUNG	  b e:   v ui:   l k e: r uu nn 
BEWEGE	  b @ v e: g @ 
BEWEGEN	  b @ v e: g @ n 
BEWEGUNG	  b @ v e: g uu nn 
BEWEIS	  b @ v ai s 
BEWEISLAST	  b @ v ai s l a s t 
BEWIESEN	  b @ v i: z @ n 
BEWUSSTLOSIGKEIT	  b @ v uu s ss t l o: z ii cc k ai t 
BEWäHRUNG	  b e:   v ee:   h r uu nn 
BEWäHRUNGSHELFER	  b e:   v ee:   h r uu nn s h ee l f ei 
BEZAHLEN	  b @ t s aa: l @ n 
BEZAHLT	  b @ t s aa: l t 
BEZEICHNET	  b @ t s ai cc n @ t 
BEZEICHNUNG	  b @ t s ai cc n uu nn 
BEZIEHT	  b @ t s i: t 
BEZIEHUNG	  b @ t s i: uu nn 
BEZIEHUNGEN	  b @ t s i: uu nn @ n 
BEZIEHUNGSWEISE	  b @ t s i: uu nn s v ai z @ 
BEZIRKS	  b @ t s ii r k s 
BEZUG	  b @ t s u: k 
BEZüGLICH	  b e:   t s y:   g l ii cc 
BGB	  b e: g e: b e: 
BILD	  b ii l t 
BILDEN	  b ii l d @ n 
BILDES	  b ii l d @ s 
BILDET	  b ii l d @ t 
BILLIG	  b ii l ii cc 
BILLIGEN	  b ii l ii g @ n 
BIN	  b ii n 
BIS	  b ii s 
BISHER	  b ii ss ei 
BISSCHEN	  b ii s cc @ n 
BIST	  b ii s t 
BIT	  b i: t 
BITRATEN	  b ii t r aa: t @ n 
BITS	  b i: t s 
BITTE	  b ii t @ 
BIßCHEN	  b e:   qq i: s   cc e: n 
BLAUE	  b l au @ 
BLAUEN	  b l au @ n 
BLEIBEN	  b l ai b @ n 
BLEIBT	  b l ai p t 
BLOCK	  b l oo k 
BLOCKIEREN	  b l oo k i: r @ n 
BLOCKIERT	  b l oo k i: r t 
BLOCKVERSCHLüSSELUNG	  b l oo k v ei ss   l y:   s e: l uu nn 
BLOß	  b e: ee l   qq o: s 
BLUMENTOPF	  b l u: m @ n t oo p f 
BLöCKE	  b e:   l ui:   k e: 
BLöCKEN	  b e:   l ui:   k e: n 
BODEN	  b o: d @ n 
BOHRUNG	  b o: r uu nn 
BONN	  b oo n 
BRANDT	  b r a n t 
BRAUCH	  b r au x 
BRAUCHBARE	  b r au x b aa: r @ 
BRD	  b e: ee r d e: 
BREITENGRAD	  b r ai t @ n g r aa: t 
BREMSBELäGE	  b r ee m s b @   l ee:   g e: 
BREMSE	  b r ee m z @ 
BREMSEN	  b r ee m z @ n 
BREMSHEBEL	  b r ee m s h e: b @ l 
BREMSLEISTUNG	  b r ee m s l ai s t uu nn 
BREMSMANTEL	  b r ee m s m a n t @ l 
BREMSTRäGER	  b r e: m s t   qq r ee:   g e: r 
BREMSWIRKUNG	  b r ee m s v ii r k uu nn 
BRIEFUMSCHLAG	  b r i: f uu m ss l aa: k 
BRILLE	  b r ii l @ 
BRRRR	  b e: ee r ee r ee r ee r 
BUCHSTABE	  b uu x s t aa: b @ 
BUCHSTABEN	  b uu x s t aa: b @ n 
BUCHT	  b uu x t 
BUCHTEN	  b uu x t @ n 
BUNDESMINISTER	  b uu n d ee s m i: n ii s t ei 
BUNDESORGANE	  b uu n d e: z oo r g aa: n @ 
BUNDESPOLIZEI	  b uu n d ee s p o: l i: t s ai 
BUNDESPäSIDENT	  b uu n d @ s   p ee:   z i: d ee n t 
BUNDESRAT	  b uu n d ee s r aa: t 
BUNDESREGIERUNG	  b uu n d ee s r e: g i: r uu nn 
BUNDESREPUBLIK	  b uu n d ee s r e: p u: b l i: k 
BUNDESTAG	  b uu n d ee s t aa: k 
BUNDESTAGSPRäSIDENT	  b uu n d ee s t a g s p   qq r ee:   z i: d ee n t 
BUNDESVERFASSUNGSGERICHT	  b uu n d ee s v ei f a s uu nn s g @ r ii cc t 
BUNDESVERFASSUNGSGERICHTSGESETZ	  b uu n d ee s v ei f a s uu nn s g @ r ii cc t s g e: z ee t s 
BYTE	  b ai t 
BZW	  b @ t s i: h uu nn s v ai z @ 
BüCHER	  b y:   cc e: r 
BüNDIG	  b y:   n d i: k 
BüRGER	  b y:   qq r g ei 
BüRGERIN	  b y:   qq r g e: r ii n 
BüRGERRECHTEN	  b y:   qq r g ee r r ee cc t @ n 
C	  s e: 
C'S	  s e: t s 
CHARAKTERISTISCHE	  cc a r a k t e: r ii s t ii ss @ 
CLIENT	  k l ii ee n t 
CLIENTS	  k l ii ee n t s 
CM	  s e: ee m 
COMPUTER	  k @ m p j u: t ei 
COMPUTERN	  k oo m p u: t @ r n 
COMPUTERNETZWERK	  k oo m p u: t ei n ee t s v ee r k 
COMPUTERS	  k @ m p j u: t ei z 
DA	  d aa: 
DABEI	  d a b ai 
DACHVERBAND	  d a x v ei b a n t 
DADRUNTER	  d a d r uu n t ei 
DADURCH	  d aa: d uu r x 
DAFüR	  d aa:   f y:   qq ee r 
DAHER	  d aa: h ee r 
DAMALS	  d a m aa: l s 
DAMIT	  d aa: m ii t 
DANACH	  d a n a x 
DANEBEN	  d a n e: b @ n 
DANK	  d a nn k 
DANN	  d a n 
DARAN	  d aa: r a n 
DARAUFHIN	  d a r au f h ii n 
DARF	  d a r f 
DARSTELLT	  d a r s t ee l t 
DARUM	  d a r uu m 
DARUNTER	  d a r uu n t ei 
DARüBER	  d aa:   qq r y:   b e: r 
DAS	  d a s 
DASS	  d a s 
DASS_BAD	  d a s   b aa: t 
DATEI	  d a t ai 
DATEIEN	  d a t ai @ n 
DATEN	  d aa: t @ n 
DATENAUSTAUSCH	  d a t @ n qq au s t au ss 
DATENBANK	  d a t @ n b a nn k 
DATENFLUSS	  d a t @ n f l uu s 
DATENMENGE	  d a t @ n m ee nn @ 
DATENPAKET	  d a t @ n p aa: k @ t 
DATENPAKETE	  d a t @ n p a k @ t @ 
DATENüBERTRAGUNG	  d aa: t @   n y:   b ee r t r a g uu nn 
DATENüBERTRAGUNGSRATE	  d aa: t @   n y:   b ee r t r a g uu nn s r aa: t @ 
DATUM	  d a t u: m 
DAUERHAFT	  d au ei h a f t 
DAUERHAFTE	  d au ei h a f t @ 
DAUERN	  d au @ r n 
DAVON	  d aa: f oo n 
DAZU	  d aa: t s u: 
DAZWISCHEN	  d a t s v ii ss @ n 
DDR	  d e: d e: ee r 
DE	  d e: 
DEFINIERT	  d e: f i: n i: r t 
DEFINITION	  d e: f i: n i: t s ii o: n 
DEKODIEREN	  d e: k o: d i: r @ n 
DELIKT	  d e: l ii k t 
DELIKTISCHE	  d e: l ii k t ii ss @ 
DEM	  d e: m 
DEMOKRATIE	  d e: m o: k r a t i: 
DEN	  d e: n 
DENN	  d ee n 
DENNOCH	  d ee n oo x 
DER	  d ee r 
DERARTIGE	  d e: r a r t ii g @ 
DEREN	  d ee r @ n 
DERER	  d ee r ei 
DES	  d ee s 
DESIGNS	  d ii z ai n z 
DESTO	  d ee s t o: 
DEUTLICH	  d oy t l ii cc 
DEUTSCHE	  d oy t ss @ 
DEUTSCHEM	  d oy t ss @ m 
DEUTSCHEN	  d oy t ss @ n 
DEUTSCHLAND	  d oy t ss l a n t 
DIAGONALE	  d i: a g o: n aa: l @ 
DICH	  d ii cc 
DICKERE	  d ii k @ r @ 
DIE	  d i: 
DIEB	  d i: p 
DIEJENIGE	  d i: j e: n ii g @ 
DIEJENIGEN	  d i: j e: n ii g @ n 
DIENEN	  d i: n @ n 
DIENSTE	  d i: n s t @ 
DIENT	  d i: n t 
DIES	  d i: z 
DIESE	  d i: z @ 
DIESEM	  d i: z @ m 
DIESEN	  d i: z @ n 
DIESER	  d i: z ei 
DIESES	  d i: z @ s 
DIGITALE	  d i: g i: t aa: l @ 
DIGITALEN	  d i: g i: t aa: l @ n 
DING	  d ii nn 
DINGE	  d ii nn @ 
DINGLICHE	  d ii nn l ii cc @ 
DINGLICHEN	  d ii nn l ii cc @ n 
DINGLICHES	  d ii nn l ii cc @ s 
DIR	  d i: r 
DIREKT	  d i: r ee k t 
DIREKTES	  d i: r ee k t @ s 
DIS	  d i: s 
DISPOSITION	  d ii s p o: z i: t s ii o: n 
DOCH	  d oo x 
DOKUMENT	  d o: k u: m ee n t 
DOPPELT	  d oo p @ l t 
DORT	  d oo r t 
DOWNLOAD	  d oo v n l o: aa: t 
DOWNLOADS	  d oo v n l o: a t s 
DRAHTLOS	  d r aa: t l o: s 
DRAHTLOSE	  d r aa: t l o: z @ 
DRAHTLOSEN	  d r aa: t l o: z @ n 
DRAN	  d r aa: n 
DRAUF	  d r au f 
DREH	  d r e: 
DREHE	  d r e: @ 
DREHEN	  d r e: @ n 
DREHGRIFF	  d r e: g r ii f 
DREHST	  d r e: s t 
DREHT	  d r e: t 
DREI	  d r ai 
DREIER-	  d r ai ei 
DREIERRIEGEL	  d r ai ee r r i: g @ l 
DREIERS	  d r ai ei s 
DREIMAL	  d r ai m aa: l 
DRESDEN	  d r ee s d @ n 
DRIN	  d r i: n 
DRINNE	  d r ii n @ 
DRITTE	  d r ii t @ 
DRITTEN	  d r ii t @ n 
DRITTER	  d r ii t ei 
DRITTSCHADENSLIQUIDATION	  d r ii t ss a d ee n s l i: k v i: d a t s ii o: n 
DROGENHANDEL	  d r o: g @ n h a n d @ l 
DROMEDAR	  d r o: m e: d aa: r 
DROMEDARS	  d r o: m e: d aa: r s 
DROMEDARZIELOBJEKTES	  d r o: m e: d a r t s i: l oo b j ee k t @ s 
DRüBER	  d e:   qq r y:   b e: r 
DSL	  d e: ee s ee l 
DU	  d u: 
DUALISTISCHE	  d u: a l ii s t ii ss @ 
DUMM	  d uu m 
DURCH	  d uu r cc 
DURCHGEFüHRT	  d uu r cc g @   f y:   h aa: ee r t e: 
DURCHMESSER	  d uu r cc m ee s ei 
DURCHMESSERS	  d uu r cc m ee s ei s 
DURCHSCHNITTLICHE	  d uu r cc ss n ii t l ii cc @ 
DURCHSCHNITTLICHEN	  d uu r cc ss n ii t l ii cc @ n 
DYNAMISCH	  d y: n a m ii ss 
DYNAMISCHE	  d y: n a m ii ss @ 
DüRFEN	  d y:   qq r f @ n 
DüRFTE	  d y:   qq r f t @ 
E-MAILS	  qq e:   m ee ii l z 
EBENE	  qq e: b @ n @ 
EBENFALLS	  qq e: b @ n f a l s 
ECHTEN	  qq ee cc t @ n 
ECKE	  qq ee k @ 
EGAL	  qq e: g aa: l 
EH	  qq e: 
EHRENRüHRIGE	  qq e: r @ n   qq r y:   h r i: g @ 
EHRENRüHRIGEN	  qq e: r @ n   qq r y:   h r i: g @ n 
EIGENE	  qq ai g @ n @ 
EIGENEN	  qq ai g @ n @ n 
EIGENER	  qq ai g @ n ei 
EIGENHEIMEN	  qq ai g @ n h ai m @ n 
EIGENSCHAFT	  qq ai g @ n ss a f t 
EIGENSCHAFTEN	  qq ai g @ n ss a f t @ n 
EIGENSTäNDIGES	  qq ai g @ n s   t ee:   n d i: g @ s 
EIGENTLICH	  qq ai g @ n t l ii cc 
EIGENTLICHEN	  qq ai g @ n t l ii cc @ n 
EIGENTUM	  qq ai g @ n t u: m 
EIGENTUMS	  qq ai g @ n t u: m s 
EIGENTüMER	  qq ai g @ n   t y:   m e: r 
EIN	  qq ai n 
EINBEZIEHEN	  qq ai n b @ t s i: @ n 
EINBEZIEHUNG	  qq ai n b @ t s i: uu nn 
EINBEZOGEN	  qq ai n b @ t s o: g @ n 
EINBRECHER	  qq ai n b r ee cc ei 
EINDEUTIGER	  qq ai n d oy t ii g ei 
EINDRUCK	  qq ai n d r uu k 
EINE	  qq ai n @ 
EINEM	  qq ai n @ m 
EINEN	  qq ai n @ n 
EINER	  qq ai n ei 
EINES	  qq ai n @ s 
EINFACH	  qq ai n f a x 
EINFACHE	  qq ai n f a x @ 
EINFACHEN	  qq ai n f a x @ n 
EINFACHER	  qq ai n f a x ei 
EINFACHEREN	  qq ai n f a x @ r @ n 
EINFAHRTZEIT	  qq ai n f aa: r t s ai t 
EINFAMILIENHAUS	  qq ai n f a m i: l ii @ n h au s 
EINFüGEN	  qq ai n   f y:   g e: n 
EINGEBAUT	  qq ai n g @ b au t 
EINGEFüGT	  qq ai nn @   f y:   g e: t e: 
EINGEFüGTEN	  qq ai nn @   f y:   g t e: n 
EINGEGRIFFEN	  qq ai n g @ g r ii f @ n 
EINGELEGT	  qq ai n g @ l e: k t 
EINGEPASST	  qq ai n g @ p a s t 
EINGEREICHT	  qq ai n g @ qq r ai cc t 
EINGESCHRäNKT	  qq ai n g ee ss   qq r ee:   qq ee n k aa: t e: 
EINGESEHEN	  qq ai n g @ z e: @ n 
EINGESETZT	  qq ai n g @ z ee t s t 
EINGESTELLT	  qq ai n g @ ss t ee l t 
EINGEWöHNUNG	  qq ai nn @   v ui:   h n uu nn 
EINGRIFF	  qq ai n g r ii f 
EINHALTUNG	  qq ai n h a l t uu nn 
EINIGE	  qq ai n ii g @ 
EINIGEN	  qq ai n ii g @ n 
EINIGER	  qq ai n ii g ei 
EINIGERMAßEN	  qq ai n ii g @ r m   qq aa: s   qq e: n 
EINIGKEIT	  qq ai n ii g k ai t 
EINIGUNG	  qq ai n ii g uu nn 
EINLEGEN	  qq ai n l e: g @ n 
EINMAL	  qq ai n m aa: l 
EINNAHMEN	  qq ai n n aa: m @ n 
EINNEHMEN	  qq ai n n e: m @ n 
EINREDE	  qq ai n r e: d @ 
EINS	  qq ai n s 
EINSATZ	  qq ai n z a t s 
EINSATZBEREIT	  qq ai n z a t s b e: r ai t 
EINSCHIEBEN	  qq ai n ss i: b @ n 
EINSCHLAG	  qq ai n ss l aa: k 
EINSCHRäNKEN	  qq ai n ss   qq r ee:   n k e: n 
EINSEHBAR	  qq ai n z e: b aa: r 
EINSETZEN	  qq ai n z ee t s @ n 
EINSTELLUNG	  qq ai n ss t ee l uu nn 
EINTRETEN	  qq ai n t r e: t @ n 
EINVERSTäNDNIS	  qq ai n v e: r s   t ee:   n d n i: s 
EINWANDERER	  qq ai n v a n d @ r ei 
EINWENDUNG	  qq ai n v ee n d uu nn 
EINWENDUNGEN	  qq ai n v ee n d uu nn @ n 
EINWILLIGUNG	  qq ai n v ii l ii g uu nn 
EINWIRKEN	  qq ai n v ii r k @ n 
EINWOHNER	  qq ai n v o: n ei 
EINZELHEITEN	  qq ai n t s ee l h ai t @ n 
EINZELNE	  qq ai n t s ee l n @ 
EINZELNEN	  qq ai n t s ee l n @ n 
EINZIGE	  qq ai n t s i: g @ 
EINZIGEN	  qq ai n t s i: g @ n 
EINZIGES	  qq ai n t s i: g @ s 
EINZUDRINGEN	  qq ai n t s u: d r ii nn @ n 
EINZUFüGENDEM	  qq qq ai n t s u:   f y:   g ee n d @ m 
ELEFANTEN	  qq e: l e: f a n t @ n 
ELEKTRONISCHE	  qq e: l ee k t r o: n ii ss @ 
ELEMENT	  qq e: l e: m ee n t 
ELEMENTE	  qq e: l e: m ee n t @ 
ELEMENTEN	  qq e: l e: m ee n t @ n 
ELEPHANTEN	  qq e: l ee f a n t @ n 
ELEPHANTENFIGUR	  qq e: l ee f a n t @ n f i: g u: r 
ELEPHANTENFUß	  qq e: l ee f a n t ee n f   qq u: s 
ELEPHANTENS	  qq e: l ee f a n t @ n s 
ELEPHANTENZIELFIGUR	  qq e: l ee f a n t @ n t s i: l f i: g u: r 
EMPFANGEN	  qq ee m p f a nn @ n 
EMPFANGSQUALITäT	  qq ee m p f a nn s k v a l i:   t ee:   t e: 
EMPFANGSRICHTUNG	  qq ee m p f a nn s r ii cc t uu nn 
EMPFANGSZUSTäNDIGKEIT	  qq ee m p f a nn s t s uu s   t ee:   n d ii cc k ai t 
EMPFäNGER	  qq ee m p   f ee:   nn e: r 
EMPFäNGERIN	  qq ee m p   f ee:   nn e: r ii n 
EMPFäNGERS	  qq ee m p   f ee:   nn e: r s 
ENDBENUTZER	  qq ee n t b @ n uu t s ei 
ENDE	  qq ee n d @ 
ENDEN	  qq ee n d @ n 
ENDGERäT	  qq ee n d g @   qq r ee:   t e: 
ENERGIEERSPARNIS	  qq e: n ee r g i: ei s p a r n ii s 
ENERGIEVERBRAUCH	  qq e: n ee r g i: v ei b r au x 
ENG	  qq ee nn 
ENGEREN	  qq ee nn @ r @ n 
ENGLISCH	  qq ee nn l ii ss 
ENTFERNT	  qq ee n t f ee r n t 
ENTFERNUNG	  qq ee n t f ee r n uu nn 
ENTGEGEN	  qq ee n t g e: g @ n 
ENTGEGENGEWIRKT	  qq ee n t g e: g @ n g @ v ii r k t 
ENTHALTEN	  qq ee n t h a l t @ n 
ENTLEHNT	  qq ee n t l e: n t 
ENTSCHEIDEN	  qq ee n t ss ai d @ n 
ENTSCHEIDET	  qq ee n t ss ai d @ t 
ENTSCHEIDUNG	  qq ee n t ss ai d uu nn 
ENTSCHEIDUNGEN	  qq ee n t ss ai d uu nn @ n 
ENTSCHEIDUNGSFREIHEIT	  qq ee n t ss ai d uu nn s f r ai h ai t 
ENTSCHIEDEN	  qq ee n t ss i: d @ n 
ENTSCHLüSSELN	  qq ee n t ss   l y:   s ee l n 
ENTSCHLüSSELUNG	  qq ee n t ss   l y:   s e: l uu nn 
ENTSPRECHENDE	  qq ee n t ss p r ee cc @ n d @ 
ENTSPRICHT	  qq ee n t ss p r ii cc t 
ENTSTAND	  qq ee n t ss t a n t 
ENTSTANDEN	  qq ee n t ss t a n d @ n 
ENTSTEHEN	  qq ee n t ss t e: @ n 
ENTSTEHT	  qq ee n t ss t e: t 
ENTWEDER	  qq ee n t v e: d ei 
ENTWICKELT	  qq ee n t v ii k @ l t 
ENTWICKLUNG	  qq ee n t v ii k l uu nn 
ENTWICKLUNGSGESCHICHTLICH	  qq ee n t v ii k l uu nn s g @ ss ii cc t l ii cc 
ENTWICKLUNGSSTADIUM	  qq ee n t v ii k l uu nn s ss t a d i: uu m 
ER	  qq ee r 
ERARBEITEN	  qq ee r qq a r b ai t @ n 
ERBFALL	  qq ee r b f a l 
ERBRACHT	  qq ee r b r a x t 
ERFASST	  qq ee r f a s t 
ERFOLGEN	  qq ee r f oo l g @ n 
ERFOLGREICHES	  qq ee r f oo l g r ai cc @ s 
ERFOLGSORT	  qq ee r f oo l g s qq oo r t 
ERFOLGT	  qq ee r f oo l k t 
ERFORDERLICH	  qq ee r f oo r d ei l ii cc 
ERFüLLEN	  qq qq ee r   f y:   l e: n 
ERFüLLUNG	  qq qq ee r   f y:   l uu nn 
ERFüLLUNGSGEHILFE	  qq qq ee r   f y:   l uu nn s g @ h ii l f @ 
ERGEBEN	  qq ee r g e: b @ n 
ERGIBT	  qq ee r g i: p t 
ERGäNZENDE	  qq qq ee r   g ee:   n t s ee n d @ 
ERHALTEN	  qq ee r h a l t @ n 
ERHARD	  qq ee r h a r t 
ERHEBEN	  qq ee r h e: b @ n 
ERHEBLICH	  qq ee r h e: b l ii cc 
ERHEBLICHE	  qq ee r h e: b l ii cc @ 
ERHITZT	  qq ee r h ii t s t 
ERHITZUNG	  qq ee r h ii t s uu nn 
ERHOBEN	  qq ee r h o: b @ n 
ERHäLTLICH	  qq qq ee r   h ee:   l t l ii cc 
ERHöHT	  qq qq ee r   h ui:   h aa: t e: 
ERHöHTE	  qq qq ee r   h ui:   h t e: 
ERINNERE	  qq ee r qq ii n @ r @ 
ERINNERN	  qq ee r qq ii n @ r n 
ERINNERT	  qq ee r qq ii n @ r t 
ERINNERUNG	  qq ee r qq ii n @ r uu nn 
ERKENNBAR	  qq ee r k ee n b aa: r 
ERKENNTNIS	  qq ee r k ee n t n ii s 
ERKENNTNISSE	  qq ee r k ee n t n ii s @ 
ERKLäRT	  qq ee r k   l ee:   qq ee r t e: 
ERKLäRUNGSEMPFäNGER	  qq ee r k   l ee:   qq r uu nn z ee m p   f ee:   nn e: r 
ERKLäRUNGSEMPFäNGERIN	  qq ee r k   l ee:   qq r uu nn z ee m p   f ee:   nn e: r ii n 
ERLANGT	  qq ee r l a nn t 
ERLAUBT	  qq ee r l au p t 
ERLEDIGT	  qq ee r l e: d ii cc t 
ERLEICHTERT	  qq ee r l ai cc t @ r t 
ERLISCHT	  qq ee r l ii ss t 
ERLOSCHEN	  qq ee r l oo ss @ n 
ERLöSCHEN	  qq qq ee r   l ui:   s cc e: n 
ERMITTELN	  qq ee r m ii t @ l n 
ERMäCHTIGUNGSGRUNDLAGE	  qq qq ee r   m ee:   cc t ii g uu nn s g r uu n d l aa: g @ 
ERMöGLICHEN	  qq qq ee r   m ui:   g l ii cc @ n 
ERMöGLICHT	  qq qq ee r   m ui:   g l ii cc t 
ERNSTLICH	  qq ee r n s t l ii cc 
ERNSTLICHKEIT	  qq ee r n s t l ii cc k ai t 
ERREICHBARKEIT	  qq ee r qq r ai cc b a r k ai t 
ERREICHEN	  qq ee r qq r ai cc @ n 
ERREICHT	  qq ee r qq r ai cc t 
ERSCHEINEN	  qq ee r ss ai n @ n 
ERSCHEINUNG	  qq ee r ss ai n uu nn 
ERSCHöPFT	  qq ee r s k   h ui:   p e: ee f t e: 
ERSETZT	  qq ee r z ee t s t 
ERST	  qq e: r s t 
ERSTATTEN	  qq ee r ss t a t @ n 
ERSTE	  qq e: r s t @ 
ERSTEN	  qq e: r s t @ n 
ERSTE_REIHE	  qq e: r s t @   qq r ai h @ 
ERSTMAL	  qq e: r s t m a l 
ERWECKT	  qq ee r v ee k t 
ERWEITERN	  qq ee r v ai t @ r n 
ERWEITERUNGEN	  qq ee r v ai t @ r qq uu nn @ n 
ERWERB	  qq ee r v ee r p 
ERWERBER	  qq ee r v ee r b ei 
ERWERBERIN	  qq ee r v ee r b @ r ii n 
ERWORBEN	  qq ee r v oo r b @ n 
ERZEUGEN	  qq ee r t s oy g @ n 
ERZIELBARE	  qq ee r t s i: l b aa: r @ 
ES	  qq ee z 
ES_HUNDERTACHTZIG_GRAD	  qq ee z   h uu n d ei t a x t s ii cc   g r aa: t 
ES_NEUNZIG_GRAD_LINKS	  qq ee z   n oy n t s ii cc   g r aa: t   l ii nn k s 
ES_UND_LEGE_ES_SO_IN_DEN_BAUCH_DES_ELEFANTEN	  qq ee z   qq uu n t   l e: g @   qq ee z   z o:   qq qq ii n   d e: n   b au x   d ee s   qq e: l e: f a n t @ n 
ETWA	  qq ee t v aa: 
ETWAS	  qq ee t v aa: s 
EVENTUELL	  qq e: v @ n t u: ee l 
EXAKT	  qq ee k s a k t 
EXOTEN	  qq ee k s o: t @ n 
EXPERIMENTE	  qq ee k s p e: r i: m ee n t @ 
EXPERIMENTEN	  qq ee k s p e: r i: m ee n t @ n 
EXPLORER	  qq ee k s p l o: r ei 
EXTERNE	  qq ee k s t @ r n @ 
EXTREME	  qq ee k s t r e: m @ 
F	  qq ee f 
FACHHäNDLER	  f a x   h ee:   n d l e: r 
FACHPERSONAL	  f a x p ei z o: n aa: l 
FAHRRAD	  f aa: r aa: t 
FAHRTANTRITT	  f aa: r t a n t r ii t 
FAKTOREN	  f a k t o: r @ n 
FALL	  f a l 
FALLEN	  f a l @ n 
FALSCH	  f a l ss 
FAMILIE	  f a m i: l ii @ 
FAMILIENMITGLIEDER	  f a m i: l ii @ n m ii t g l i: d ei 
FAMILIENRECHT	  f a m i: l ii @ n r ee cc t 
FAST	  f a s t 
FEHLENDE	  f e: l @ n d @ 
FEHLER	  f e: l ei 
FEHLT	  f e: l t 
FELD	  f ee l t 
FELDER	  f ee l d ei 
FELDES	  f ee l d @ s 
FELDKABEL	  f ee l d k aa: b @ l 
FENSTER	  f e: n s t ei 
FERNER	  f ee r n ei 
FERNSEHEN	  f ee r n z e: @ n 
FERNSEHPROGRAMME	  f ee r n z e: p r oo g r a m @ 
FERTIG	  f ee r t ii cc 
FEST	  f ee s t 
FESTEN	  f ee s t @ n 
FESTGELEGT	  f ee s t g @ l e: k t 
FESTIGUNGSGEWEBE	  f ee s t qq ii g uu nn s g @ v e: b @ 
FESTSTELLEN	  f ee s t ss t ee l @ n 
FETTENDEN	  f ee t @ n d @ n 
FEUDALISMUS	  f oy d aa: l ii s m uu s 
FIGUR	  f i: g u: r 
FIGUREN	  f i: g u: r @ n 
FILEZILLA	  f i: l e: t s ii l aa: 
FINANZAMT	  f i: n a n t s a m t 
FINANZKREISLAUF	  f i: n a n t s k r ai s l au f 
FINDEN	  f ii n d @ n 
FINDET	  f ii n d @ t 
FINNLAND	  f ii n l a n t 
FIREFOX	  f i: r e: f oo k s 
FIRMEN	  f ii r m @ n 
FIXIERBUCHSE	  f ii k s i: r b uu k s @ 
FIXIERT	  f ii k s i: r t 
FLUGHäFEN	  f l u: g   h ee:   f e: n 
FLUGROST	  f l u: g r oo s t 
FLäCHE	  qq ee f   l ee:   cc e: 
FLäCHEN	  qq ee f   l ee:   cc e: n 
FLäCHENINHALTE	  qq ee f   l ee:   cc e: n ii n h a l t @ 
FLäCHENTARIFVERTRAG	  qq ee f   l ee:   cc ee n t a r ii f v ei t r aa: k 
FOLGE	  f oo l g @ 
FOLGEN	  f oo l g @ n 
FOLGENDE	  f oo l g @ n d @ 
FOLGENDERMAßEN	  f oo l g ee n d @ r m   qq aa: s   qq e: n 
FORDERUNG	  f oo r d @ r uu nn 
FORDERUNGSRECHT	  f oo r d e: r uu nn s r ee cc t 
FORDERUNGSRECHTE	  f oo r d e: r uu nn s r ee cc t @ 
FORDERUNGSZUSTäNDIGKEIT	  f oo r d e: r uu nn s t s uu s   t ee:   n d ii cc k ai t 
FORM	  f oo r m 
FORMFREIHEIT	  f oo r m f r ai h ai t 
FORMVORSCHRIFTEN	  f oo r m v oo r ss r ii f t @ n 
FORT	  f oo r t 
FORTSCHRITT	  f oo r t ss r ii t 
FORWARDING	  f oo @ v ei d ii nn 
FRAGEN	  f r aa: g @ n 
FRAGESTELLUNGEN	  f r a g ee s t ee l uu nn @ n 
FRAKTION	  f r a k t s ii o: n 
FRANKREICH	  f r a nn k r ai cc 
FRANZöSISCH	  f r aa: n   t s ui:   z ii ss 
FRANZöSISCHEN	  f r aa: n   t s ui:   z ii ss @ n 
FRAU	  f r au 
FREI	  f r ai 
FREIBIER	  f r ai b i: r 
FREIBLEIBT	  f r ai b l ai p t 
FREIE	  f r ai @ 
FREIEN	  f r ai @ n 
FREIES	  f r ai @ s 
FREIHEIT	  f r ai h ai t 
FREIHEITLICHE	  f r ai h ai t l ii cc @ 
FREIHEITSKAMPF	  f r ai h ai t s k a m p f 
FREIHEITSSTRAFE	  f r ai h ai t s ss t r aa: f @ 
FREIRAUM	  f r ai r au m 
FREIWILLIG	  f r ai v ii l ii cc 
FREIWILLIGE	  f r ai v ii l ii g @ 
FREMDEN	  f r ee m d @ n 
FREMDES	  f r ee m d @ s 
FREQUENZANALYSE	  f r e: k v @ n t s a n a l y: z @ 
FREQUENZBAND	  f r e: k v @ n t s b a n t 
FREQUENZBäNDER	  f r e: k v ee n t s   b ee:   n d e: r 
FREQUENZEN	  f r e: k v ee n t s @ n 
FREQUENZKANAL	  f r e: k v @ n t s k a n aa: l 
FREUND	  f r oy n t 
FRIST	  f r ii s t 
FRüCHTE	  qq ee f   qq r y:   cc t e: 
FRüHEN	  qq ee f   qq r y:   h e: n 
FRüHER	  qq ee f   qq r y:   h e: r 
FRüHEREN	  qq ee f   qq r y:   h e: r @ n 
FUNKNETZ	  f uu nn k n ee t s 
FUNKTECHNIK	  f uu nn k t ee cc n i: k 
FUNKTION	  f uu nn k t s ii o: n 
FUNKTIONALITäT	  f uu nn k t s ii o: n a l i:   t ee:   t e: 
FUNKTIONEN	  f uu nn k t s ii o: n @ n 
FUNKTIONIERT	  f uu nn k t s ii o: n i: r t 
FUSSES	  f uu s @ s 
FUß	  qq ee f   qq u: s 
FUßBODEN	  qq ee f   qq u: s   b o: d @ n 
FäLLE	  f ee:   l e: 
FüGE	  f y:   g e: 
FüGT	  f y:   g e: t e: 
FüHREN	  f y:   h ee r @ n 
FüHRTE	  f y:   h r t @ 
FüHRUNGSSTEG	  f y:   h r uu nn s ss t e: k 
FüLLT	  f y:   qq ee l ee l t e: 
FüNF	  f y:   qq ee n ee f 
FüNFERLIEGENDEN	  f y:   n f ee r l i: g @ n d @ n 
FüR	  f y:   qq ee r 
GAB	  g aa: p 
GANG	  g a nn 
GANGSCHALTUNG	  g a nn ss a l t uu nn 
GANZ	  g a n t s 
GANZE	  g a n t s @ 
GANZEN	  g a n t s @ n 
GAR	  g aa: r 
GATEWAYS	  g a t e: v ai s 
GEANTWORTET	  g @ qq a n t v oo r t @ t 
GEBEN	  g e: b @ n 
GEBIET	  g @ b i: t 
GEBILDE	  g @ b ii l d @ 
GEBRAUCH	  g @ b r au x 
GEBUNDEN	  g @ b uu n d @ n 
GEBüHR	  g e:   b y:   h ee r 
GEDIENT	  g @ d i: n t 
GEDREHT	  g @ d r e: t 
GEDREHTE	  g @ d r e: t @ 
GEDREHTEN	  g @ d r e: t @ n 
GEDREHTES	  g @ d r e: t @ s 
GEEIGNET	  g @ qq ai g n @ t 
GEFAHR	  g @ f aa: r 
GEFUNDEN	  g @ f uu n d @ n 
GEFäHRDET	  g e:   f ee:   h r d e: t 
GEFäLSCHTE	  g e:   f ee:   qq ee l ss t e: 
GEFäNGNIS	  g e:   f ee:   nn n i: s 
GEFöRDERT	  g e:   f ui:   qq r d ei t 
GEFüHRT	  g e:   f y:   h aa: ee r t e: 
GEFüLLT	  g e:   f y:   qq ee l ee l t e: 
GEGEBEN	  g @ g e: b @ n 
GEGEN	  g e: g @ n 
GEGENEINANDER	  g e: g @ n qq ai n a n d ei 
GEGENMEINUNG	  g e: g @ n m ai n uu nn 
GEGENSATZ	  g e: g @ n z a t s 
GEGENSTAND	  g e: g @ n ss t a n t 
GEGENSäTZE	  g e: g @ n   z ee:   t s e: 
GEGENWäRTIG	  g e: g @ n   v ee:   qq r t i: k 
GEGENWäRTIGE	  g e: g @ n   v ee:   qq r t i: g @ 
GEGENWäRTIGEN	  g e: g @ n   v ee:   qq r t i: g @ n 
GEGENüBER	  g @ g e:   n y:   b e: r 
GEHACKT	  g @ h a k t 
GEHALTEN	  g @ h a l t @ n 
GEHEIM	  g @ h ai m 
GEHEIME	  g @ h ai m @ 
GEHEIMEN	  g @ h ai m @ n 
GEHEIMHALTUNG	  g @ h ai m h a l t uu nn 
GEHEIMTEXT	  g @ h ai m t ee k s t 
GEHEIMTEXTE	  g @ h ai m t ee k s t @ 
GEHEIMTEXTS	  g @ h ai m t ee k s t s 
GEHEN	  g e: @ n 
GEHT	  g e: t 
GEHT'S	  g e: t s 
GEHTS	  g e: t s 
GEHöREN	  g e:   h ui:   qq ee r @ n 
GEHöRT	  g e:   h ui:   qq ee r t e: 
GEISTESWISSENSCHAFTEN	  g ai s t ee s v ii s @ n ss a f t @ n 
GEKAUFTEN	  g @ k au f t @ n 
GEKIPPTE	  g @ k ii p t @ 
GEKIPPTES	  g @ k ii p t @ s 
GEKNACKT	  g @ k n a k t 
GEKOMMEN	  g @ k oo m @ n 
GEKRüMMTE	  g e: k   qq r y:   m t e: 
GELANGEN	  g @ l a nn @ n 
GELANGT	  g @ l a nn t 
GELD	  g ee l t 
GELDSTRAFE	  g ee l d s t r aa: f @ 
GELDWäSCHE	  g ee l t   v ee:   ss e: 
GELEGEN	  g @ l e: g @ n 
GELEGTEN	  g @ l e: g t @ n 
GELERNT	  g @ l ee r n t 
GELTEN	  g ee l t @ n 
GELTEND	  g ee l t @ n t 
GELTENDGEMACHT	  g ee l t @ n d g e: m a x t 
GELTENDMACHEN	  g ee l t @ n d m a x @ n 
GELTUNGSBEREICH	  g ee l t uu nn s b @ r ai cc 
GEMACHT	  g @ m a x t 
GEMEINSAM	  g @ m ai n z aa: m 
GEMEINSAMKEITEN	  g @ m ai n z aa: m k ai t @ n 
GEMEINSCHAFT	  g @ m ai n ss a f t 
GEMEINSCHAFTEN	  g @ m ai n ss a f t @ n 
GEMEINTE	  g @ m ai n t @ 
GEMELDET	  g @ m ee l d @ t 
GEMäß	  g e:   m ee: s 
GEMäßIGTE	  g e:   m ee: s   qq ii cc t @ 
GENANNT	  g @ n a n t 
GENANNTEN	  g @ n a n t @ n 
GENAU	  g @ n au 
GENAUIGKEIT	  g @ n au ii cc k ai t 
GENAUSO	  g @ n au z o: 
GENERATION	  g e: n e: r a t s ii o: n 
GENERIERT	  g e: n e: r i: r t 
GENIEßEN	  g @ n i:   qq e: s   qq e: n 
GENOMMEN	  g @ n oo m @ n 
GENUG	  g @ n u: k 
GENUTZT	  g @ n uu t s t 
GENüGEND	  g e:   n y:   g ee n t 
GEPACKT	  g @ p a k t 
GEPFLEGT	  g @ p f l e: k t 
GEPLANTE	  g @ p l a n t @ 
GERADE	  g @ qq r aa: d @ 
GERADEN	  g @ qq r aa: d @ n 
GEREGELT	  g @ qq r e: g @ l t 
GERICHT	  g @ qq r ii cc t 
GERICHTE	  g @ qq r ii cc t @ 
GERING	  d z ei r ii nn 
GERINGE	  g @ qq r ii nn @ 
GERINGER	  g @ qq r ii nn ei 
GERINGERER	  g @ qq r ii nn @ r ei 
GERäT	  g e:   qq r ee:   t e: 
GERäTE	  g e:   qq r ee:   t e: 
GERäTEN	  g e:   qq r ee:   t e: n 
GERüGT	  g e:   qq r y:   g e: t e: 
GESAGT	  g @ z aa: g t 
GESAMMELT	  g @ z a m @ l t 
GESAMTE	  g @ z a m t @ 
GESAMTEN	  g @ z a m t @ n 
GESCHAFFEN	  g @ ss a f @ n 
GESCHICHTE	  g @ ss ii cc t @ 
GESCHLOSSEN	  g @ ss l oo s @ n 
GESCHLOSSENER	  g @ ss l oo s @ n ei 
GESCHOBEN	  g @ ss o: b @ n 
GESCHULTES	  g @ ss u: l t @ s 
GESCHWINDIGKEIT	  g @ ss v ii n d ii cc k ai t 
GESCHäDIGTE	  g ee s k   h ee:   d ii cc t @ 
GESCHäFTEN	  g ee s k   h ee:   f t e: n 
GESCHäFTS	  g ee s k   h ee:   qq ee f t e: ee s 
GESCHäFTSKUNDEN	  g ee s k   h ee:   qq ee f t s k uu n d @ n 
GESCHäFTSUNFäHIGEN	  g ee s k   h ee:   f t z u: n   f ee:   h i: g @ n 
GESCHüTZT	  g ee s k   h y:   t e: t s ee t t e: 
GESEHEN	  g @ z e: @ n 
GESENDET	  g @ z ee n d @ t 
GESENKT	  g @ z ee nn k t 
GESETZ	  g @ z ee t s 
GESETZBLATT	  g @ z ee t s b l a t 
GESETZES	  g @ z ee t s @ s 
GESETZESKRAFT	  g @ z ee t s ee s k r a f t 
GESETZLICHE	  g @ z ee t s l ii cc @ 
GESETZLICHEN	  g @ z ee t s l ii cc @ n 
GESETZT	  g @ z ee t s t 
GESPEICHERT	  g @ ss p ai cc @ r t 
GESPIEGELT	  g @ ss p i: g @ l t 
GESPIEGELTE	  g @ ss p i: g @ l t @ 
GESPIEGELTEN	  g @ ss p i: g @ l t @ n 
GESPIEGELTES	  g @ ss p i: g @ l t @ s 
GESPRäCH	  g ee ss p   qq r ee:   s e: h aa: 
GESTAUCHTES	  g @ ss t au x t @ s 
GESTELLT	  g @ ss t ee l t 
GESTRECKTES	  g @ ss t r ee k t @ s 
GESTäRKT	  g e: s   t ee:   qq ee r k aa: t e: 
GESUCHT	  g @ z u: x t 
GESUNDHEITSZUSTAND	  g @ z uu n t h ai t s t s uu s t a n t 
GETAN	  g @ t aa: n 
GETEILT	  g @ t ai l t 
GETEILTES	  g @ t ai l t @ s 
GETRENNTE	  g @ t r ee n t @ 
GETRIEBENABE	  g @ t r i: b @ n aa: b @ 
GEWALT	  g @ v a l t 
GEWANN	  g @ v a n 
GEWESEN	  g @ v e: z @ n 
GEWINNE	  g @ v ii n @ 
GEWINNEN	  g @ v i: n @ n 
GEWINNST	  g @ v ii n s t 
GEWINNT	  g @ v ii n t 
GEWISSE	  g @ v ii s @ 
GEWISSERMAßEN	  g @ v ii s @ r m   qq aa: s   qq e: n 
GEWOLLT	  g @ v oo l t 
GEWORDEN	  g @ v oo r d @ n 
GEWäHLT	  g e:   v ee:   h aa: ee l t e: 
GEWäHRLEISTEN	  g e:   v ee:   h r l ai s t @ n 
GEWäHRLEISTET	  g e:   v ee:   h r l ai s t @ t 
GEWüNSCHTE	  g e:   v y:   qq ee n ss t e: 
GEZAHLT	  g @ t s aa: l t 
GEZWUNGEN	  g @ t s v uu nn @ n 
GEZäHLT	  g e:   t s ee:   h aa: ee l t e: 
GEöFFNET	  g e:   qq e: ui:   f n e: t 
GIBT	  g i: p t 
GILT	  g ii l t 
GLASFASERTECHNIK	  g l a s f a z ei t ee cc n i: k 
GLATT	  g l a t 
GLAUBE	  g l au b @ 
GLAUBEN	  g l au b @ n 
GLAUBST	  g l au b s t 
GLEICH	  g l ai cc 
GLEICHE	  g l ai cc @ 
GLEICHEN	  g l ai cc @ n 
GLEICHLANG	  g l ai cc l a nn 
GLEICHSCHENKLIGE	  g l ai cc ss @ n k l ii g @ 
GLEICHSCHENKLIGER	  g l ai cc ss @ n k l ii g ei 
GLEICHWERTIGEM	  g l ai cc v ee r t ii g @ m 
GLEICHZEITIG	  g l ai cc t s ai t ii cc 
GLIEDERT	  g l i: d @ r t 
GLäUBIGER	  g e:   l ee:   qq u: b ii g ei 
GLäUBIGERS	  g e:   l ee:   qq u: b i: g ei s 
GLüCKLICH	  g e:   l y:   k l ii cc 
GLüCKLICHERWEISE	  g e:   l y:   k l ii cc ei v ai z @ 
GNUBBEL	  g n uu b @ l 
GNUBBELN	  g n uu b @ l n 
GNUBBELS	  g n uu b @ l s 
GOLD	  g oo l t 
GOLDKLAUSEL	  g oo l d k l au z @ l 
GOLDKLAUSELN	  g oo l d k l au z @ l n 
GOTT	  g oo t 
GRAD	  g r aa: t 
GRADNACH	  g r a d n a x 
GRAFISCHE	  g r a f ii ss @ 
GRAFISCHEN	  g r a f ii ss @ n 
GREIFT	  g r ai f t 
GRENZE	  g r ee n t s @ 
GRENZEN	  g r ee n t s @ n 
GRENZT	  g r ee n t s t 
GRIFF	  g r ii f 
GRIFFE	  g r ii f @ 
GROß	  g e: ee r   qq o: s 
GROßE	  g e: ee r   qq o: s   qq e: 
GROßEN	  g e: ee r   qq o: s   qq e: n 
GROßER	  g e: ee r   qq o: s   qq ee r 
GRUND	  g r uu n t 
GRUNDGESETZ	  g r uu n d g e: z ee t s 
GRUNDLEGENDE	  g r uu n d l e: g @ n d @ 
GRUNDORDNUNG	  g r uu n d oo r d n uu nn 
GRUNDRECHT	  g r uu n d r ee cc t 
GRUNDRECHTE	  g r uu n d r ee cc t @ 
GRUNDRECHTEN	  g r uu n d r ee cc t @ n 
GRUNDRECHTS	  g r uu n d r ee cc t s 
GRUNDRECHTSFäHIG	  g r uu n d r ee cc t s   f ee:   h i: k 
GRUNDRECHTSGLEICHEN	  g r uu n d r ee cc t s g l ai cc @ n 
GRUNDRECHTSINHALT	  g r uu n d r ee cc t s ii n h a l t 
GRUNDRECHTSMüNDIG	  g r uu n d r ee cc t s   m y:   n d i: k 
GRUNDRECHTSVERLETZUNG	  g r uu n d r ee cc t s v ei l ee t s uu nn 
GRUNDRECHTSVERWIRKUNG	  g r uu n d r ee cc t s v ei v ii r k uu nn 
GRUNDSATZ	  g r uu n d z a t s 
GRUNDSTüCKS	  g r uu n t s   t y:   s e: k aa: ee s 
GRUNDSäTZLICH	  g r uu n t   z ee:   t s l ii cc 
GRUPPE	  g r uu p @ 
GRößE	  g e:   qq r ui: s   qq e: 
GRößEN	  g e:   qq r ui: s   qq e: n 
GRößER	  g e:   qq r ui: s   qq ee r 
GRößERE	  g e:   qq r ui: s   qq ee r qq e: 
GRößERER	  g e:   qq r ui: s   qq e: r ei 
GRüNEN	  g e:   qq r y:   n e: n 
GUCKT	  g uu k t 
GUNSTEN	  g u: n s t @ n 
GUT	  g u: t 
GUTE	  g u: t @ 
GUTEN	  g u: t @ n 
GüNSTIGER	  g y:   n s t i: g ei 
HABE	  h aa: b @ 
HABEN	  h aa: b @ n 
HAFTUNG	  h a f t uu nn 
HAFTUNGSBESCHRäNKUNGEN	  h a f t uu nn s b ee ss   qq r ee:   n k uu nn @ n 
HALB	  h a l p 
HALBIERT	  h a l b i: r t 
HALS	  h aa: l s 
HALSES	  h a l z @ s 
HALT	  h a l t 
HALTUNG	  h a l t uu nn 
HAND	  h a n t 
HANDBREMSHEBEL	  h a n d b r ee m s h e: b @ l 
HANDELT	  h a n d @ l t 
HANDHABEN	  h a n t h aa: b @ n 
HANDLUNGSFREIHEIT	  h a n d l uu nn s f r ai h ai t 
HANDY	  h a n d ii 
HASH	  h a ss 
HAST	  h a s t 
HAT	  h a t 
HAUFEN	  h au f @ n 
HAUPTLEISTUNG	  h au p t l ai s t uu nn 
HAUPTSäCHLICH	  h au p t   z ee:   cc l ii cc 
HAUPTZIEL	  h au p t s i: l 
HAUS	  h au s 
HAUSEIGENTüMER	  h au s qq ai g @ n   t y:   m e: r 
HAUSES	  h au z @ s 
HAUSTüR	  h au s   t y:   qq ee r 
HEBEL	  h e: b @ l 
HEINRICH	  h ai n r ii cc 
HEIßT	  h e:   qq i: s   t e: 
HERANGEZOGEN	  h ee r a n g @ t s o: g @ n 
HERAUS	  h ee r au s 
HERAUSDREHEN	  h ee r au s d r e: @ n 
HERAUSGABE	  h ee r au s g aa: b @ 
HERAUSGEFUNDEN	  h ee r au s g @ f uu n d @ n 
HERAUSGENOMMEN	  h ee r au s g @ n oo m @ n 
HERAUSGESTELLT	  h ee r au s g @ ss t ee l t 
HERGELEITET	  h ee r g @ l ai t @ t 
HERSTELLEN	  h ee r s t ee l @ n 
HERSTELLER	  h ee r s t ee l ei 
HERUM	  h ee r uu m 
HERVORGEBRACHT	  h ee r f oo r g @ b r a x t 
HERVORRAGENDES	  h ee r f oo r qq r aa: g @ n d @ s 
HEUTIGEN	  h oy t ii g @ n 
HIER	  h i: r 
HIERBEI	  h i: r b ai 
HIERDURCH	  h i: r d uu r cc 
HIERFüR	  h i: r   f y:   qq ee r 
HIERUNTER	  h i: r uu n t ei 
HIERZU	  h i: r t s u: 
HILFE	  h ii l f @ 
HILFSPERSONEN	  h ii l f s p ee r z o: n @ n 
HILFSWISSENSCHAFT	  h ii l f s v ii s @ n ss a f t 
HIN	  h ii n 
HINAUSSTEHENDE	  h ii n au s ss t e: @ n d @ 
HINDURCH	  h ii n d uu r cc 
HINEIN	  h ii n ai n 
HINEINRAGT	  h ii n ai n qq r aa: k t 
HINGEGEN	  h ii nn e: g @ n 
HINGELEGT	  h ii n g @ l e: k t 
HINREICHEND	  h ii n r ai cc @ n t 
HINTEN	  h ii n t @ n 
HINTER	  h ii n t ei 
HINTERBEIN	  h ii n t ei b ai qq ee n 
HINTERE	  h ii n t ei qq e: 
HINTEREN	  h ii n t ei @ n 
HINTERFUß	  h ii n t @ r f   qq u: s 
HINTERN	  h ii n t @ r n 
HINTERRAD	  h ii n t ei qq r aa: t 
HINTERRADGABEL	  h ii n t ei qq r a d g aa: b @ l 
HINTERTEIL	  h ii n t ei t ai l 
HINZUGEFüGT	  h ii n t s u: g e:   f y:   g e: t e: 
HMHM	  h aa: ee m h aa: ee m 
HOBEL	  h o: b @ l 
HOCH	  h o: x 
HOCHEBENE	  h o: x qq e: b @ n @ 
HOHEITLICHE	  h o: ai t l ii cc @ 
HOHEITLICHEN	  h o: ai t l ii cc @ n 
HOHEITSAKT	  h o: ai t z a k t 
HOHER	  h o: ei 
HOLZ	  h oo l t s 
HORIZONTAL	  h o: r i: t s oo n t aa: l 
HUNDERTACHTIG_GRAD	  h uu n d ei t a x t ii cc   g r aa: t 
HUNDERTACHTZIG	  h uu n d ei t a x t s ii cc 
HUNDERTACHTZIG_GRAD	  h uu n d ei t a x t s ii cc   g r aa: t 
HUNDERTACHZIG_GRAD	  h uu n d ei t a x t s ii cc   g r aa: t 
HäLFTE	  h ee:   l f t e: 
HäLFTEN	  h ee:   l f t e: n 
HäLTST	  h ee:   qq ee l t e: ee s t e: 
HäNDE	  h ee:   n d e: 
HäNDLER	  h ee:   n d l e: r 
HäNGEN	  h ee:   nn e: n 
HäNGT	  h ee:   qq ee n g e: t e: 
HäTTE	  h ee:   t e: 
HäUFIG	  h ee:   qq u: f ii cc 
HäUFIGER	  h ee:   qq u: f ii g ei 
HäUFIGKEIT	  h ee:   qq u: f ii cc k ai t 
HöCHSTE	  h ui:   s e: h s t e: 
HöCHSTENS	  h ui:   s e: h s t e: n s 
HöCHSTSTRAFE	  h ui:   s e: h aa: ee s t e: ss t r aa: f @ 
HöCKER	  h ui:   k e: r 
HöCKERS	  h ui:   k e: r s 
HöCKERTEIL	  h ui:   k ee r t ai l 
HöHE	  h ui:   h e: 
HöHERE	  h ui:   h e: r @ 
HöHEREN	  h ui:   h e: r @ n 
HöHERER	  h ui:   h e: r ei 
HöHERRANGIGES	  h ui:   h ee r a nn ii g @ s 
HüBSCHE	  h y:   b e: ss e: 
HüBSCHEN	  h y:   b e: s cc e: n 
HüLLE	  h y:   l e: 
HüTER	  h y:   t e: r 
I	  qq i: 
ICH	  qq ii cc 
IDENTIFIZIERT	  qq i: d @ n t i: f i: t s i: r t 
IHM	  qq i: m 
IHN	  qq i: n 
IHR	  qq i: r 
IHRE	  qq i: r @ 
IHREN	  qq i: r @ n 
ILLUSTRIERTE	  qq ii l uu s t r i: r t @ 
IM	  qq ii m 
IMAGINäR	  qq ii m a g i:   n ee:   qq ee r 
IMMER	  qq ii m ei 
IMPLEMENTIEREN	  qq ii m p l e: m @ n t i: r @ n 
IN	  qq ii n 
INDIREKTEN	  qq ii n d i: r ee k t @ n 
INFORMATIONEN	  qq ii n f oo r m a t s ii o: n @ n 
INFRAGE	  qq ii n f r aa: g @ 
INFRASTRUKTUR	  qq ii n f r a s t r uu k t u: r 
INGENIEURWISSENSCHAFT	  qq ii nn e: n i: uu r v ii s @ n ss a f t 
INHALT	  qq ii n h a l t 
INHALTSFREIHEIT	  qq ii n h a l t s f r ai h ai t 
INLAND	  qq ii n l a n t 
INLäNDISCHE	  qq qq ii n   l ee:   n d ii ss @ 
INNERHALB	  qq ii n ei h a l p 
INNERSTAATLICHEN	  qq ii n ei s t aa: t l ii cc @ n 
INS	  qq ii n s 
INSBESONDERE	  qq ii n s b e: z oo n d @ r @ 
INSEKTENBEFALL	  qq ii n z ee k t ee n b @ f a l 
INSGEHEIM	  qq ii n s g e: ai m 
INSGESAMT	  qq ii n s g e: z a m t 
INSTALLATION	  qq ii n s t a l a t s ii o: n 
INSTALLATIONEN	  qq ii n s t a l a t s ii o: n @ n 
INSTALLIERT	  qq ii n s t a l i: r t 
INSTANZENZUGES	  qq ii n s t a n t s ee n t s u: g @ s 
INTERESSANTEN	  qq ii n t @ r ee s a n t @ n 
INTERESSEN	  qq ii n t @ r ee s @ n 
INTERNATIONALE	  qq ii n t @ r n a t s ii o: n aa: l @ 
INTERNATIONALEN	  qq ii n t @ r n a t s ii o: n aa: l @ n 
INTERNATIONALER	  qq ii n t @ r n a t s ii o: n aa: l ei 
INTERNE	  qq ii n t ee r n @ 
INTERNEN	  qq ii n t ee r n @ n 
INTERNET	  qq ii n t ee r n @ t 
INTERNETANBIETERN	  qq ii n t @ r n e: t a n b i: t @ r n 
INTERNETFOREN	  qq ii n t @ r n ee t f o: r @ n 
INTERNETNUTZER	  qq ii n t @ r n ee t n uu t s ei 
INTERNETPROTOKOLL	  qq ii n t @ r n ee t p r o: t o: k oo l 
INTERNETRADIO	  qq ii n t @ r n ee t r a d ii o: 
INTERNETZUGANG	  qq ii n t @ r n ee t s u: g a nn 
INVESTIEREN	  qq ii n v ee s t i: r @ n 
INVESTITION	  qq ii n v ee s t i: t s ii o: n 
IP	  qq i: p 
IRGENDEINEN	  qq ii r g @ n d ai n @ n 
IRGENDWAS	  qq ii r g @ n d v aa: s 
ISDN	  qq ii s d n 
IST	  qq ii s t 
JA	  j aa: 
JAHR	  j aa: r 
JAHRE	  j aa: r @ 
JAHREN	  j aa: r @ n 
JAHRES	  j aa: r @ s 
JAHRHUNDERTS	  j aa: r h uu n d @ r t s 
JAHRZEHNTE	  j aa: r t s e: n t @ 
JAKOB	  j a k o: p 
JE	  j e: 
JEDE	  j e: d @ 
JEDEN	  j e: d @ n 
JEDENFALLS	  j e: d @ n f a l s 
JEDER	  j e: d ei 
JEDERMANN	  j e: d ei m a n 
JEDERZEIT	  j e: d ei t s ai t 
JEDES	  j e: d @ s 
JEDOCH	  j e: d oo x 
JEMAND	  j e: m a n t 
JEMANDEM	  j e: m a n d @ m 
JETZT	  j ee t s t 
JETZTE	  j ee t s t @ 
JEWEILIGE	  j e: v ai l ii g @ 
JEWEILIGEN	  j e: v ai l ii g @ n 
JEWEILS	  j e: v ai l s 
JUNI	  j u: n i: 
JURISTISCHE	  j u: r ii s t ii ss @ 
KABEL	  k a b @ l 
KABELLOSEN	  k a b @ l o: z @ n 
KABELTROMMEL	  k a b @ l t r oo m @ l 
KABELVERBINDUNGEN	  k a b @ l v ei b ii n d uu nn @ n 
KAMEL	  k a m @ l 
KAMELS	  k a m @ l s 
KANADA	  k a n a d aa: 
KANADIERN	  k a n a d i: r n 
KANADISCHE	  k a n a d ii ss @ 
KANN	  k a n 
KANNST	  k a n s t 
KANTE	  k a n t @ 
KANäLE	  k aa:   n ee:   l e: 
KAPAZITäT	  k a p a t s i:   t ee:   t e: 
KAPITALISMUS	  k a p i: t a l ii s m uu s 
KAPUTTGEGANGEN	  k a p uu t g e: g a nn @ n 
KARLSRUHE	  k a r l s r u: @ 
KASERNEN	  k a z @ r n @ n 
KASTEN	  k a s t @ n 
KATASTROPHEN	  k a t a s t r oo f @ n 
KAUFE	  k au f @ 
KAUFVERTRAG	  k au f v ei t r aa: k 
KAUM	  k au m 
KEIN	  k ai n 
KEINE	  k ai n @ 
KEINEN	  k ai n @ n 
KENNEN	  k ee n @ n 
KENNT	  k ee n t 
KENNTNIS	  k ee n t n ii s 
KENNZEICHEN	  k ee n t s ai cc @ n 
KETTE	  k ee t @ 
KETTENBLATT	  k ee t @ n b l a t 
KINDES	  k ii n d @ s 
KLAR	  k l aa: r 
KLARTEXT	  k l a r t ee k s t 
KLASSISCHE	  k l a s ii ss @ 
KLEBT	  k l e: p t 
KLEINE	  k l ai n @ 
KLEINEM	  k l ai n @ m 
KLEINEN	  k l ai n @ n 
KLEINES	  k l ai n @ s 
KLINGT	  k l ii nn t 
KLOTZ	  k l oo t s 
KM	  k i: l o: m e: t ei 
KOLLEKTIVBEZEICHNUNG	  k oo l ee k t ii v b e: t s ai cc n uu nn 
KOLLISIONSFREIHEIT	  k oo l i: z ii o: n s f r ai h ai t 
KOLLISIONSRECHT	  k oo l i: z ii o: n s r ee cc t 
KOMBINATION	  k oo m b i: n a t s ii o: n 
KOMBINATIONEN	  k oo m b i: n a t s ii o: n @ n 
KOMBINIERT	  k oo m b i: n i: r t 
KOMMANDOZEILENSCHNITTSTELLE	  k oo m a n d o: t s ai l ee n ss n ii t s t ee l @ 
KOMMEN	  k oo m @ n 
KOMMERZIELLEN	  k oo m ee r t s j ee l @ n 
KOMMT	  k oo m t 
KOMMUNALEN	  k oo m u: n aa: l @ n 
KOMMUNALVERFASSUNGSSTREIT	  k oo m u: n a l v ei f a s uu nn s ss t r ai t 
KOMMUNIKATIONSMITTEL	  k oo m u: n i: k a t s ii o: n s m ii t @ l 
KOMPATIBEL	  k oo m p a t i: b @ l 
KOMPATIBILITäT	  k oo m p a t i: b i: l i:   t ee:   t e: 
KOMPLETT	  k oo m p l ee t 
KOMPLETTE	  k oo m p l ee t @ 
KOMPLETTIERT	  k oo m p l ee t i: r t 
KOMPLEXE	  k oo m p l ee k s @ 
KONKRETE	  k oo nn k r e: t @ 
KONKRETEN	  k oo nn k r e: t @ n 
KONKURRENTEN	  k oo n k uu r ee n t @ n 
KONNTE	  k oo n t @ 
KONNTEN	  k oo n t @ n 
KONSEQUENZEN	  k oo n z e: k v ee n t s @ n 
KONSTRUKTION	  k oo n s t r uu k t s ii o: n 
KONTINUIERLICH	  k oo n t i: n u: qq i: r l ii cc 
KONTINUIERLICHER	  k oo n t i: n u: qq i: r l ii cc ei 
KONTRAHIERUNGSZWANG	  k oo n t r aa: i: r uu nn s t s v a nn 
KONZEPT	  k oo n t s ee p t 
KOPF	  k oo p f 
KOPFES	  k oo p f @ s 
KOPFSEITE	  k oo p f z ai t @ 
KOPFTEIL	  k oo p f t ai l 
KOPIERT	  k o: p i: r t 
KORREKT	  k oo r @ k t 
KORRIGIEREN	  k oo r i: g i: r @ n 
KOSTENFREI	  k oo s t @ n f r ai 
KOSTENLOS	  k oo s t @ n l o: s 
KOSTENLOSER	  k oo s t @ n l o: z ei 
KOSTENLOSES	  k oo s t @ n l o: z @ s 
KOTTENFORST	  k oo t @ n f o: r s t 
KRAFT	  k r a f t 
KREDITINSTITUT	  k r e: d i: t ii n s t i: t u: t 
KREUZ	  k r oy t s 
KREUZES	  k r oy t s @ s 
KREUZFIGUR	  k r oy t s f i: g u: r 
KRIMINELLER	  k r i: m i: n ee l ei 
KRITERIUM	  k r i: t e: r i: uu m 
KRITISCHE	  k r i: t ii ss @ 
KRYPTOANALYSE	  k r yy p t o: a n a l y: z @ 
KRYPTOGRAFISCHE	  k r yy p t oo g r a f ii ss @ 
KRYPTOGRAFISCHEN	  k r yy p t oo g r a f ii ss @ n 
KRYPTOSYSTEM	  k r yy p t o: z yy s t @ m 
KRäFTIG	  k aa:   qq r ee:   f t i: k 
KUNDEN	  k uu n d @ n 
KUPFERADERN	  k uu p f e: r a d @ r n 
KUPFERLEITUNG	  k uu p f ei l ai t uu nn 
KURBEL	  k uu r b @ l 
KURVEN	  k uu r v @ n 
KURZ	  k uu r t s 
KURZE	  k uu r t s @ 
KURZEN	  k uu r t s @ n 
KäMPFERISCHE	  k ee:   m p f e: r ii ss @ 
KäMPFTEN	  k ee:   qq ee m p f t e: n 
KäSTCHEN	  k ee:   qq ee s t e: cc @ n 
KäUFER	  k ee:   qq u: f ei 
KöNNEN	  k ui:   n e: n 
KöNNTE	  k ui:   n t e: 
KöNNTEN	  k ui:   n t e: n 
KöRPER	  k ui:   qq r p ei 
KöRPERMITTE	  k ui:   qq r p ei m ii t @ 
KüNDIGUNGSRECHTE	  k y:   n d ii g uu nn s r ee cc t @ 
KüRZLICH	  k y:   qq r t s l ii cc 
L	  qq ee l 
LADENEIGENTüMER	  l a d @ n ai g @ n   t y:   m e: r 
LADENSCHLUSSGESETZ	  l a d @ n ss l uu s g e: z ee t s 
LAN	  l aa: n 
LAND	  l a n t 
LANDESEBENE	  l a n d @ s qq e: b @ n @ 
LANDESINNERN	  l a n d @ s qq ii n @ r n 
LANDESVERFASSUNGSGERICHT	  l a n d @ s f ee r f a s uu nn s g @ r ii cc t 
LANG	  l a nn 
LANGE	  l a nn @ 
LANGEN	  l a nn @ n 
LANGWEILIG	  l a nn v ai l ii cc 
LANS	  l aa: n s 
LASCHEN	  l a ss @ n 
LASSEN	  l a s @ n 
LAUBHöLZER	  l au p   h ui:   l t s e: r 
LAUFE	  l au f @ 
LAUFENDE	  l au f @ n d @ 
LAUTET	  l au t @ t 
LEBEN	  l e: b @ n 
LEBENSDAUER	  l e: b @ n s d au ei 
LEBENSJAHR	  l e: b @ n s j aa: r 
LEBENSLANGE	  l e: b @ n s l a nn @ 
LEBENSSACHVERHALT	  l e: b @ n s a x v ei h a l t 
LEBTEN	  l e: p t @ n 
LEDIGLICH	  l e: d ii g l ii cc 
LEER	  l e: r 
LEERE	  l e: r @ 
LEEREN	  l e: r @ n 
LEERSTELLE	  l e: r s t ee l @ 
LEG	  l e: k 
LEGALEN	  l e: g aa: l @ n 
LEGE	  l e: g @ 
LEHRE	  l e: r @ 
LEICHT	  l ai cc t 
LEICHTES	  l ai cc t @ s 
LEIDER	  l ai d ei 
LEIPZIG	  l ai p t s ii cc 
LEISTUNG	  l ai s t uu nn 
LEISTUNGSNäHE	  l ai s t uu nn s   n ee:   h e: 
LENKER	  l ee nn k ei 
LESBAR	  l e: z b aa: r 
LETZTE	  l ee t s t @ 
LETZTEN	  l ee t s t @ n 
LEUTEN	  l oy t @ n 
LIEFERANT	  l i: f e: r a n t 
LIEFERTE	  l i: f @ r t @ 
LIEGEN	  l i: g @ n 
LIEGENDE	  l i: g @ n d @ 
LIEGENDEM	  l i: g @ n d @ m 
LIEGENDEN	  l i: g @ n d @ n 
LIEGENDES	  l i: g @ n d @ s 
LIEGT	  l i: k t 
LIMIT	  l i: m ii t 
LINIE	  l i: n ii @ 
LINK	  l ii nn k 
LINKE	  l ii nn k @ 
LINKEN	  l ii nn k @ n 
LINKERE	  l ii nn k @ r @ 
LINKS	  l ii nn k s 
LINKSBüNDIG	  l ii nn k s   b y:   n d i: k 
LINKSSEITIG	  l ii nn k s ai t ii cc 
LIZENZ	  l i: t s ee n t s 
LIZENZGEBüHREN	  l i: t s ee n t s g @   b y:   h ee r @ n 
LOCH	  l oo x 
LOGIK	  l o: g i: k 
LOGISCHER	  l o: g ii ss ei 
LOHNEN	  l o: n @ n 
LOHNENSWERT	  l o: n @ n s v ee r t 
LOTTO	  l oo t o: 
LUDWIG	  l uu d v ii cc 
LäNGE	  l ee:   nn e: 
LäNGEN	  l ee:   nn e: n 
LäNGER	  l ee:   nn e: r 
LäNGEREM	  l ee:   nn e: r @ m 
LäNGEREN	  l ee:   nn e: r @ n 
LäNGERER	  l ee:   nn e: r ei 
LäSST	  l ee:   qq ee s ee s t e: 
LöCHER	  l ui:   cc e: r 
LöST	  l ui:   qq ee s t e: 
LöSUNG	  l ui:   z uu nn 
LöSUNGEN	  l ui:   z uu nn @ n 
LüBKE	  l y:   b k e: 
LüCKE	  l y:   k e: 
M	  qq ee m 
MACHEN	  m a x @ n 
MACHTE	  m a x t @ 
MAINBOARD	  m ee ii n b oo @ d 
MAKIERT	  m a k i: r t 
MAL	  m aa: l 
MAN	  m a n 
MANGEL	  m a nn @ l 
MANGELHAFTE	  m a nn @ l h a f t @ 
MANN	  m a n 
MANTEL	  m a n t @ l 
MARKIERTEN	  m a r k i: r t @ n 
MARKTWIRTSCHAFT	  m a r k t v ii r t ss a f t 
MATHEMATIK	  m a t h e: m a t i: k 
MATHEMATISCHE	  m a t h e: m aa: t ii ss @ 
MATHEMATISCHEN	  m a t h e: m aa: t ii ss @ n 
MATHEMATISCHER	  m a t h e: m aa: t ii ss ei 
MAUL	  m au l 
MAßNAHMEN	  qq ee m   qq aa: s   n aa: m @ n 
MECHANISMEN	  m ee cc a n ii s m @ n 
MEHR	  m e: r 
MEHRERE	  m e: r @ r @ 
MEHREREN	  m e: r @ r @ n 
MEHRMALS	  m e: r m aa: l s 
MEILE	  m ai l @ 
MEIN	  m ai n 
MEISTEN	  m ai s t @ n 
MENGE	  m ee nn @ 
MENSCHEN	  m ee n ss @ n 
MERKEN	  m ee r k @ n 
METER	  m e: t ei 
METHODEN	  m e: t o: d @ n 
MH	  qq ee m h aa: 
MHM	  qq ee m h aa: ee m 
MICH	  m ii cc 
MIETER	  m i: t ei 
MIETERIN	  m i: t @ r ii n 
MIETRECHT	  m i: t qq r ee cc t 
MIETVERHäLTNIS	  m i: t v ei   h ee:   l t n i: s 
MIETVERTRAG	  m i: t f ee r t r aa: k 
MIETWOHNUNG	  m i: t v o: n uu nn 
MIKROWELLE	  m i: k r o: v ee l @ 
MILLIONEN	  m ii l j o: n @ n 
MINDESTENS	  m ii n d @ s t @ n s 
MINDESTFREIHEITSSTRAFE	  m ii n d ee s t f r ai h ai t s ss t r aa: f @ 
MINDESTLOHN	  m ii n d ee s t l o: n 
MINUTEN	  m i: n u: t @ n 
MIR	  m i: r 
MIT	  m ii t 
MITBEWERBERN	  m ii t b @ v ee r b @ r n 
MITEINANDER	  m ii t qq ai n a n d ei 
MITGETEILT	  m ii t g @ t ai l t 
MITGLIEDER	  m ii t g l i: d ei 
MITTE	  m ii t @ 
MITTEILUNG	  m ii t t ai l uu nn 
MITTEL	  m ii t @ l 
MITTELKANTE	  m ii t @ l k a n t @ 
MITTELLINIE	  m ii t @ l i: n i: 
MITTELTEIL	  m ii t @ l t ai l 
MITTIG	  m ii t t i: k 
MITTIGER	  m ii t t i: g ei 
MITTIGSTEN	  m ii t t i: g s t @ n 
MITTLERE	  m ii t l @ r @ 
MITTLEREN	  m ii t l @ r @ n 
MITTLERWEILE	  m ii t l ei v ai l @ 
MITVERSCHULDEN	  m ii t f ee r ss uu l d @ n 
MITZUTEILEN	  m ii t t s u: t ai l @ n 
MOBILFUNKNETZ	  m o: b ii l f uu nn k n ee t s 
MOBILFUNKüBERTRAGUNG	  m o: b ii l f u: n   k y:   b ee r t r a g uu nn 
MOBILTELEFON	  m o: b ii l t ee l e: f o: n 
MODERN	  m o: d ee r n 
MODERNE	  m o: d ee r n @ 
MODERNER	  m o: d ee r n ei 
MONARCHIE	  m o: n a r cc i: 
MONAT	  m o: n aa: t 
MONATEN	  m o: n aa: t @ n 
MONATS	  m o: n aa: t s 
MONISTISCHE	  m o: n ii s t ii ss @ 
MONOPOLE	  m o: n o: p o: l @ 
MONTIEREN	  m oo n t i: r @ n 
MUNITIONSLAGER	  m u: n i: t s ii o: n s l aa: g ei 
MUSIK	  m u: z i: k 
MUSS	  m uu s 
MUSSTE	  m uu s t @ 
MUTTER	  m uu t ei 
MYSQL	  m yy s k l 
MöCHTE	  m ui:   cc t e: 
MöGLICH	  m ui:   g l ii cc 
MöGLICHERWEISE	  m ui:   g l ii cc ei v ai z @ 
MöGLICHST	  m ui:   g l ii cc s t 
MüNDLICH	  m y:   n d l ii cc 
MüSSEN	  m y:   s e: n 
MüSSTE	  m y:   s ss t e: 
MüSSTEN	  m y:   s ss t e: n 
NABENACHSE	  n a b @ n a k s @ 
NACH	  n a x 
NACHDENKEN	  n a x d ee nn k @ n 
NACHEINANDER	  n a x qq ai n a n d ei 
NACHEMPFUNDEN	  n a x ee m p f uu n d @ n 
NACHGEDACHT	  n a x g e: d a x t 
NACHGEHOLT	  n a x g e: oo l t 
NACHGELESEN	  n a x g @ l e: z @ n 
NACHKRIEGSZEIT	  n a x k r i: g s t s ai t 
NACHLASSEN	  n a x l a s @ n 
NACHLäSST	  qq n a x   l ee:   qq ee s ee s t e: 
NACHREDE	  n a x r e: d @ 
NACHRICHT	  n a x r ii cc t 
NACHRICHTEN	  n a x r ii cc t @ n 
NACHSCHMIEREN	  n a x ss m i: r @ n 
NACHT	  n a x t 
NACHTEIL	  n a x t ai l 
NACHVOLLZIEHEN	  n a x f oo l t s i: @ n 
NACHVOLLZOGEN	  n a x f oo l t s o: g @ n 
NACHWACHSENDEN	  n a x v a k s @ n d @ n 
NACHWEIS	  n a x v ai s 
NACHWIRKUNGSZEIT	  n a x v ii r k uu nn s t s ai t 
NADELHöLZER	  n a d @ l   h ui:   l t s e: r 
NAJA	  n a j aa: 
NAMEN	  n aa: m @ n 
NATIONALEM	  n a t s ii o: n aa: l @ m 
NATIONALES	  n a t s ii o: n aa: l @ s 
NATURWISSENSCHAFT	  n a t uu r v ii s @ n ss a f t 
NATURWISSENSCHAFTLERN	  n a t uu r v ii s @ n ss a f t l @ r n 
NATURWISSENSCHAFTLICHE	  n a t uu r v ii s @ n ss a f t l ii cc @ 
NEBEN	  n e: b @ n 
NEBENEINANDER	  n e: b @ n qq ai n a n d ei 
NEE	  n e: 
NEHM	  n e: m 
NEHME	  n e: m @ 
NEHMEN	  n e: m @ n 
NEHME_ES	  n e: m @   qq ee z 
NEIN	  n ai n 
NENNEN	  n ee n @ n 
NENNT	  n ee n t 
NETZ	  n ee t s 
NETZE	  n ee t s @ 
NETZWERK	  n ee t s v ee r k 
NETZWERKE	  n ee t s v ee r k @ 
NETZWERKEN	  n ee t s v ee r k @ n 
NETZWERKKABEL	  n ee t s v ei k aa: b @ l 
NETZWERKKARTE	  n ee t s v ei k a r t @ 
NETZWERKKONFIGURATION	  n ee t s v ei k oo n f i: g u: r a t s ii o: n 
NETZWERKS	  n ee t s v ee r k s 
NEU	  n oy 
NEUE	  n oy @ 
NEUEN	  n oy @ n 
NEUENTWICKELTE	  n oy @ n t v ii k @ l t @ 
NEUEREN	  n oy @ r @ n 
NEUERWERB	  n oy ei v @ r p 
NEUN	  n oy n 
NEUNZIG	  n oy n t s ii cc 
NEUNZIG_GRAD	  n oy n t s ii cc   g r aa: t 
NEUNZIG_GRAD_LINKS	  n oy n t s ii cc   g r aa: t   l ii nn k s 
NEUNZIG_GRAD_NACH	  n oy n t s ii cc   g r aa: t   n a x 
NICHT	  n ii cc t 
NICHTIG	  n ii cc t ii cc 
NICHTS	  n ii cc t s 
NIEDRIGER	  n i: d r ii g ei 
NIEMALS	  n i: m aa: l s 
NIEMAND	  n i: m a n t 
NIMM	  n ii m 
NIMMT	  n ii m t 
NOCH	  n oo x 
NOCHMAL	  n oo x m aa: l 
NORM	  n oo r m 
NORMADRESSAT	  n oo r m a d r ee s aa: t 
NORMENKONTROLLE	  n oo r m @ n k oo n t r oo l @ 
NORWEGEN	  n oo r v e: g @ n 
NORWEGER	  n oo r v e: g ei 
NOTEBOOKS	  n o: t e: b o: k s 
NOTWENDIG	  n oo t v @ n d ii cc 
NOTWENDIGE	  n oo t v @ n d ii g @ 
NULL	  n uu l 
NUMMER	  n uu m ei 
NUR	  n u: r 
NUTZUNG	  n uu t s uu nn 
NäHE	  n ee:   h e: 
NäHESTEN	  n ee:   h ee s t @ n 
NöRDLICHEN	  n ui:   qq r d l ii cc @ n 
NüTZLICH	  n y:   t s l ii cc 
OB	  qq oo b 
OBEN	  qq o: b @ n 
OBERE	  qq o: b ei qq e: 
OBEREN	  qq o: b @ r @ n 
OBERFLäCHE	  qq o: b @ r f   l ee:   cc e: 
OBERHALB	  qq o: b ei h a l p 
OBERKANTE	  qq o: b ei k a n t @ 
OBERSEITE	  qq o: b ei z ai t @ 
OBERSTE	  qq o: b ei s t @ 
OBERSTEN	  qq o: b ei s t @ n 
OBJEKT	  qq oo p j ee k t 
OBJEKTE	  qq oo p j ee k t @ 
OBWOHL	  qq oo p v o: l 
ODER	  qq o: d ei 
OFFEN	  qq oo f @ n 
OFFENE	  qq oo f @ n @ 
OFFENEN	  qq oo f @ n @ n 
OFFENSICHTLICH	  qq oo f ee n z ii cc t l ii cc 
OFFIZIELL	  qq oo f i: t s j ee l 
OFFIZIELLE	  qq oo f i: t s j ee l @ 
OH	  qq o: 
OHNE	  qq o: n @ 
OHR	  qq o: r 
OHREN	  qq o: r @ n 
OK	  qq o: k e: 
OPFER	  qq oo p f ei 
OPFERS	  qq oo p f ei s 
OPTIMAL	  qq oo p t i: m aa: l 
OPTIMALE	  qq oo p t i: m aa: l @ 
OPTIONAL	  qq oo p t s ii o: n aa: l 
ORDNUNGSGEMäßER	  qq oo r d n uu nn s g @   m ee: s   qq ee r 
ORGANE	  qq oo r g aa: n @ 
ORGANSTREIT	  qq oo r g a n s t r ai t 
ORGANSTREITVERFAHREN	  qq oo r g a n s t r ai t v ei f aa: r @ n 
ORIENTIERUNGSPUNKT	  qq o: r ii ee n t i: r uu nn s p uu nn k t 
OSTEN	  qq oo s t @ n 
PACK	  p a k 
PACKE	  p a k @ 
PACKEN	  p a k @ n 
PAKETE	  p a k @ t @ 
PARABOLANTENNE	  p a r a b o: l a n t ee n @ 
PARABOLANTENNEN	  p a r a b o: l a n t ee n @ n 
PARLAMENTARISCHE	  p a r l a m @ n t a r ii ss @ 
PARTEIEN	  p a r t ai @ n 
PARTEIFäHIG	  p a r t ai   f ee:   h i: k 
PASSE	  p a s @ 
PASSEN	  p a s @ n 
PASSFORM	  p a s f oo r m 
PASSGENAU	  p a s g @ n au 
PASST	  p a s t 
PASSWORT	  p a s v oo r t 
PATENT	  p a t ee n t 
PATENTIERT	  p a t ee n t i: r t 
PATENTIERTE	  p a t ee n t i: r t @ 
PATENTIERUNG	  p a t ee n t i: r uu nn 
PATIENTEN	  p a t s ii ee n t @ n 
PER	  p e: r 
PEREMPTORISCHE	  p e: r ee m p t o: r ii ss @ 
PERMANENT	  p ee r m a n ee n t 
PERSON	  p ee r z o: n 
PERSONEN	  p ee r z o: n @ n 
PERSONENRECHTLICHEM	  p ee r s o: n @ n qq r ee cc t l ii cc @ m 
PERSöNLICHE	  p e: r   z ui:   n l ii cc @ 
PFERD	  p f e: r t 
PFLICHTEN	  p f l ii cc t @ n 
PHANTASIE	  f a n t a z i: 
PHILOSOPHIE	  f i: l o: z oo f i: 
PHYSIK	  f y: z i: k 
PHYSIKALISCHE	  f y: z i: k a l ii ss @ 
PHYSISCHE	  f y: z ii ss @ 
PLATZ	  p l a t s 
PLUGINS	  p l u: g ii n s 
PLUS	  p l uu s 
PLUSZEICHEN	  p l uu s t s ai cc @ n 
PLöTZLICH	  p e:   l ui:   t s l ii cc 
PLöTZLICHES	  p e:   l ui:   t s l ii cc @ s 
PO	  p o: 
POINT	  p o: ii n t 
POINTS	  p o: ii n t s 
POLITIK	  p o: l i: t i: k 
POLITIKER	  p o: l i: t i: k ei 
POLITISCHE	  p o: l i: t ii ss @ 
POLIZEI	  p o: l i: t s ai 
POPO	  p o: p o: 
POPULARKLAGEN	  p o: p u: l a r k l aa: g @ n 
POPULäRE	  p o: p u:   l ee:   qq r e: 
PORT	  p oo r t 
PORTS	  p oo r t s 
POSITION	  p o: z i: t s ii o: n 
POSITIONIERT	  p o: z i: t s ii o: n i: r t 
POSITIVE	  p o: z i: t i: v @ 
POSTADRESSE	  p oo s t a d r ee s @ 
PRAKTISCH	  p r a k t ii ss 
PREIS	  p r ai s 
PREISABSTAND	  p r ai z a b s t a n t 
PREISWERT	  p r ai s v ee r t 
PREISWERTE	  p r ai s v ee r t @ 
PRINZIP	  p r ii n t s i: p 
PRIORITäT	  p r ii o: r i:   t ee:   t e: 
PRIVATEN	  p r i: v aa: t @ n 
PRIVATPERSONEN	  p r i: v aa: t p ee r z o: n @ n 
PRIVATRECHT	  p r i: v aa: t qq r ee cc t 
PRIVATSPHäRE	  p r i: v a t s p   h ee:   qq r e: 
PRO	  p r o: 
PROBLEMLOS	  p r o: b l e: m l o: s 
PRODUKTE	  p r o: d uu k t @ 
PROGRAMM	  p r o: g r a m 
PROGRAMME	  p r o: g r a m @ 
PROGRAMMFEHLER	  p r o: g r a m f e: l ei 
PROGRAMMIERER	  p r o: g r a m i: r ei 
PROJEKT	  p r o: j ee k t 
PROJEKTE	  p r o: j ee k t @ 
PROPRIETäRE	  p r o: p r i:   t ee:   qq r e: 
PROTOKOLL	  p r o: t o: k oo l 
PROTOKOLLE	  p r o: t o: k oo l @ 
PROTOKOLLEN	  p r o: t o: k oo l @ n 
PROVINZ	  p r o: v ii n t s 
PROZESSFäHIG	  p r o: t s ee s   f ee:   h i: k 
PROZESSFäHIGKEIT	  p r o: t s ee s   f ee:   h ii cc k ai t 
PROZESSHINDERNIS	  p r o: t s ee s h ii n d ei n ii s 
PROZESSSTANDSCHAFT	  p r o: t s ee s s t a n d ss a f t 
PUNKT	  p uu nn k t 
PUNKTES	  p uu nn k t @ s 
PöMPEL	  p ui:   m p e: l 
QUADER	  k v aa: d ei 
QUADERN	  k v a d @ r n 
QUADRAT	  k v a d r aa: t 
QUADRATE	  k v a d r aa: t @ 
QUADRATEN	  k v a d r aa: t @ n 
QUADRATES	  k v a d r aa: t @ s 
QUADRATREIHE	  k v a d r a t r ai h @ 
QUADRATS	  k v a d r aa: t s 
QUALITäT	  k v a l i:   t ee:   t e: 
QUATSCH	  k v a t ss 
QUELLCODE	  k v ee l k o: d @ 
QUELLEN	  k v ee l @ n 
QUELLTEXT	  k v ee l t ee k s t 
RADIEN	  qq r a d ii @ n 
RAGT	  qq r aa: k t 
RAN	  qq r aa: n 
RAND	  qq r a n t 
RANDE	  qq r a n d @ 
RANGESCHOBEN	  qq r a nn ee ss o: b @ n 
RATIFIKATION	  qq r a t i: f i: k a t s ii o: n 
RAUBBAU	  qq r au b au 
RAUM	  qq r au m 
RAUS	  qq r au s 
REAGIERT	  qq r e: a g i: r t 
REALISIERT	  qq r e: a l i: z i: r t 
RECHNEN	  qq r ee cc n @ n 
RECHNERISCH	  qq r ee cc n @ r ii ss 
RECHT	  qq r ee cc t 
RECHT-	  qq r ee cc t 
RECHTE	  qq r ee cc t @ 
RECHTECK	  qq r ee cc t ee k 
RECHTECKS	  qq r ee cc t ee k s 
RECHTEN	  qq r ee cc t @ n 
RECHTESTE	  qq r ee cc t @ s t @ 
RECHTLICHEN	  qq r ee cc t l ii cc @ n 
RECHTMäßIG	  qq r ee cc t   m ee: s   qq i: k 
RECHTMäßIGEN	  qq r ee cc t   m ee: s   qq i: g @ n 
RECHTMäßIGKEIT	  qq r ee cc t   m ee: s   qq ii cc k ai t 
RECHTS	  qq r ee cc t s 
RECHTSANWäLTE	  qq r ee cc t z aa: n   v ee:   l t e: 
RECHTSANWäLTIN	  qq r ee cc t z aa: n   v ee:   l t i: n 
RECHTSBüNDIG	  qq r ee cc t s   b y:   n d i: k 
RECHTSEITIG	  qq r ee cc t z ai t ii cc 
RECHTSFOLGE	  qq r ee cc t s f oo l g @ 
RECHTSGESCHäFT	  qq r ee cc t s g ee s k   h ee:   qq ee f t e: 
RECHTSGESCHäFTLICHE	  qq r ee cc t s g ee s k   h ee:   f t l ii cc @ 
RECHTSGESCHäFTSäHNLICHE	  qq r ee cc t s g ee s k   h ee:   qq ee f t e:   z ee:   h n l ii cc @ 
RECHTSGRUNDLAGE	  qq r ee cc t s g r uu n d l aa: g @ 
RECHTSGRUNDLOS	  qq r ee cc t s g r uu n d l o: s 
RECHTSGUT	  qq r ee cc t s g u: t 
RECHTSGüTER	  qq r ee cc t s   g y:   t e: r 
RECHTSHINDERNDE	  qq r ee cc t s h ii n d @ r n d @ 
RECHTSINSTITUT	  qq r ee cc t s ii n s t i: t u: t 
RECHTSMITTEL	  qq r ee cc t s m ii t @ l 
RECHTSNORM	  qq r ee cc t s n oo r m 
RECHTSNORMEN	  qq r ee cc t s n oo r m @ n 
RECHTSPRECHUNG	  qq r ee cc t s p r ee cc uu nn 
RECHTSSATZ	  qq r ee cc t s a t s 
RECHTSSCHUTZBEDüRFNIS	  qq r ee cc t s cc uu t s b @   d y:   qq r f n ii s 
RECHTSSYSTEME	  qq r ee cc t s yy s t e: m @ 
RECHTSVERLETZUNG	  qq r ee cc t s v ei l ee t s uu nn 
RECHTSVERNICHTENDE	  qq r ee cc t s v ei n ii cc t @ n d @ 
RECHTSWEG	  qq r ee cc t s v e: k 
RECHTSWIDRIG	  qq r ee cc t s v ii d r ii cc 
RECHTS_UND	  qq r ee cc t s   qq uu n t 
RECHTZEITIG	  qq r ee cc t s ai t ii cc 
REDE	  r e: d @ 
REDUZIEREN	  r e: d u: t s i: r @ n 
REDUZIERT	  r e: d u: t s i: r t 
REGELMäßIG	  qq r e: g @ l   m ee: s   qq i: k 
REGELN	  qq r e: g @ l n 
REGELUNGEN	  qq r e: g @ l uu nn @ n 
REGENWäLDER	  qq r e: g @ n   v ee:   l d e: r 
REGNET	  qq r ee g n @ t 
REICHT	  qq r ai cc t 
REICHWEITE	  qq r ai cc v ai t @ 
REIHE	  qq r ai h @ 
REIHEN	  qq r ai h @ n 
REIN	  qq r ai n 
REINIGEN	  qq r ai n ii g @ n 
REINIGER	  qq r ai n ii g ei 
REINIGUNGSMITTEL	  qq r ai n ii g uu nn s m ii t @ l 
REINLEGT	  qq r ai n l e: k t 
REINPASSEN	  qq r ai n p a s @ n 
REINPASST	  qq r ai n p a s t 
REINRAGT	  qq r ai n r aa: k t 
REINSCHIEBEN	  qq r ai n ss i: b @ n 
REINSETZEN	  qq r ai n z ee t s @ n 
REINTUN	  qq r ai n t u: n 
REINTUT	  qq r ai n t u: t 
REITER	  qq r ai t ei 
RELATIV	  qq r e: l a t i: f 
RELATIVITäTSGRUNDSATZ	  qq r e: l a t i: v i:   t ee:   t e: s g r uu n d z a t s 
RESPEKTIEREN	  qq r ee s p ee k t i: r @ n 
RESSOURCEN	  qq r ee s u: r k @ n 
REST	  qq r ee s t 
RESULTIEREN	  qq r e: z uu l t i: r @ n 
REVOLUTIONäRE	  qq r e: v o: l u: t ii o:   n ee:   qq r e: 
RHEINISCHE	  qq r ai n ii ss @ 
RHEINISCHEN	  qq r ai n ii ss @ n 
RICHTEN	  qq r ii cc t @ n 
RICHTETE	  qq r ii cc t @ t @ 
RICHTIG	  qq r ii cc t ii cc 
RICHTUNG	  qq r ii cc t uu nn 
RIEGEL	  qq r i: g @ l 
RIEGELS	  qq r i: g @ l s 
ROHSTOFF	  qq r o: s t oo f 
ROLLE	  qq r oo l @ 
ROUTER	  qq r u: t ei 
ROUTERS	  qq r u: t ei s 
ROUTING	  r au t ii nn 
RSA	  qq r z aa: 
RUMPF	  qq r uu m p f 
RUMPFES	  qq r uu m p f @ s 
RUND	  qq r uu n t 
RUNDFUNKPROGRAMME	  qq r uu n d f uu nn k p r oo g r a m @ 
RUSSLAND	  qq r uu s l a n t 
RäNDELSCHRAUBE	  qq r ee:   n d ee l ss r au b @ 
RäUMLICHE	  qq r ee:   qq uu m l ii cc @ 
RüCKEN	  qq r y:   k e: n 
RüCKENLINIE	  qq r y:   k ee n l i: n i: 
RüCKENS	  qq r y:   k e: n s 
RüCKENTEIL	  qq r y:   k ee n t ai l 
RüCKSTAND	  qq r y:   s e: k s t a n t 
RüCKSTäNDIG	  qq r y:   s e: k aa: ee s   t ee:   n d i: k 
RüGE	  qq r y:   g e: 
RüSSEL	  qq r y:   s e: l 
S	  qq ee s 
SACHE	  z a x @ 
SACHENRECHT	  z a x @ n r ee cc t 
SACHENRECHTE	  z a x @ n r ee cc t @ 
SAG	  z aa: k 
SAGEN	  z aa: g @ n 
SALZ	  z a l t s 
SANKTION	  z a nn k t s ii o: n 
SATELLIT	  z a t @ l ii t 
SATZ	  z a t s 
SCH	  qq ee s s e: h aa: 
SCHADEN	  ss aa: d @ n 
SCHADENSERSATZ	  ss a d @ n z ei z a t s 
SCHADENSERSATZANSPRUCH	  ss a d @ n z ei z a t s a n s p r uu x 
SCHADENSERSATZPFLICHTIG	  ss a d @ n z ei z a t s p f l ii cc t ii cc 
SCHALTEN	  ss a l t @ n 
SCHALTENS	  ss a l t @ n s 
SCHALTER	  ss a l t ei 
SCHALTROHR	  ss a l t r o: r 
SCHALTSTIFT	  ss a l t s t ii f t 
SCHALTZUG	  ss a l t s u: k 
SCHARFEN	  ss a r f @ n 
SCHAUSPIELER	  ss au s p i: l ei 
SCHEIN	  ss ai n 
SCHENKEL	  ss ee n k @ l 
SCHIEBE	  ss i: b @ 
SCHIEBEN	  ss i: b @ n 
SCHIEBT	  ss i: p t 
SCHIEßT	  ss i:   qq e: s   t e: 
SCHLECHT	  ss l ee cc t 
SCHLECHTLEISTUNG	  ss l ee cc t l ai s t uu nn 
SCHLEIFEN	  ss l ai f @ n 
SCHLIEßT	  ss l i:   qq e: s   t e: 
SCHLUSS	  ss l uu s 
SCHLüSSEL	  qq ee s s e: h aa:   l y:   s e: l 
SCHLüSSELLäNGE	  qq ee s s e: h aa:   l y:   s e: l   l ee:   nn e: 
SCHLüSSELS	  qq ee s s e: h aa:   l y:   s e: l s 
SCHLüSSELSTROM	  qq ee s s e: h aa:   l y:   s ee l s t r o: m 
SCHMALE	  ss m aa: l @ 
SCHMALES	  ss m aa: l @ s 
SCHMERZ	  ss m ee r t s 
SCHMIERMITTEL	  ss m i: r m ii t @ l 
SCHNAUZE	  ss n au t s @ 
SCHNEIT	  ss n ai t 
SCHNELL	  ss n ee l 
SCHNELLE	  ss n ee l @ 
SCHNELLER	  ss n ee l ei 
SCHNELLERE	  ss n ee l @ r @ 
SCHNITTSTELLE	  ss n ii t s t ee l @ 
SCHNITTSTELLEN	  ss n ii t s t ee l @ n 
SCHON	  ss o: n 
SCHRANKENLOSE	  ss r a n k @ n l o: z @ 
SCHRAUBE	  ss r au b @ 
SCHREIBT	  ss r ai p t 
SCHRIFTLICH	  ss r ii f t l ii cc 
SCHRäG	  qq ee s s e: h aa:   qq r ee:   g e: 
SCHULDHAFT	  ss uu l t h a f t 
SCHULDNER	  ss uu l d n ei 
SCHULDNERS	  ss uu l d n ei s 
SCHULDUNFäHIG	  ss uu l d u: n   f ee:   h i: k 
SCHULDVERHäLTNIS	  ss uu l d v ei   h ee:   l t n i: s 
SCHULDVERHäLTNISSE	  ss uu l d v ei   h ee:   l t n ii s @ 
SCHULDVERHäLTNISSES	  ss uu l d v ei   h ee:   l t n ii s @ s 
SCHULTER	  ss u: l t ei 
SCHUTZ	  ss uu t s 
SCHUTZBEDüRFTIGKEIT	  ss uu t s b @   d y:   qq r f t ii cc k ai t 
SCHUTZBEREICH	  ss uu t s b e: r ai cc 
SCHUTZBüGEL	  ss uu t s   b y:   g e: l 
SCHUTZPFLICHTEN	  ss uu t s p f l ii cc t @ n 
SCHUTZWIRKUNG	  ss uu t s v ii r k uu nn 
SCHUTZZWECK	  ss uu t s v ee k 
SCHWANZ	  ss v a n t s 
SCHWEDEN	  ss v e: d @ n 
SCHWER	  ss v e: r 
SCHWEREN	  ss v e: r @ n 
SCHWäCHEN	  qq ee s s e: h aa:   v ee:   cc e: n 
SCHäDEN	  qq ee s s e:   h ee:   d e: n 
SCHäDIGER	  qq ee s s e:   h ee:   d i: g ei 
SCHöN	  qq ee s s e:   h ui:   qq ee n 
SCHöNEN	  qq ee s s e:   h ui:   n e: n 
SCHüTZEN	  qq ee s s e:   h y:   t s e: n 
SCHüTZT	  qq ee s s e:   h y:   t e: t s ee t t e: 
SECHS	  z ee k s 
SEHEN	  z e: @ n 
SEHR	  z e: r 
SEI	  z ai 
SEIL	  z ai l 
SEILHüLLE	  z ai l   h y:   l e: 
SEIN	  z ai n 
SEINE	  z ai n @ 
SEINEM	  z ai n @ m 
SEINEN	  z ai n @ n 
SEINER	  z ai n ei 
SEIT	  z ai t 
SEITE	  z ai t @ 
SEKUNDE	  z e: k uu n d @ 
SELBST	  z ee l p s t 
SELBSTSICHERNDE	  z ee l p s t z ii cc @ r n d @ 
SELTEN	  z ee l t @ n 
SENDELEISTUNG	  z ee n d @ l ai s t uu nn 
SENDEMAST	  z ee n d e: m a s t 
SENDEN	  z ee n d @ n 
SENDER	  z ee n d ei 
SENDERS	  z ee n d ei s 
SENDET	  z ee n d @ t 
SENDETE	  z ee n d @ t @ 
SEPTEMBER	  z ee p t ee m b ei 
SERVER	  s ei v ei 
SERVERN	  z ee r v @ r n 
SESSEL	  z ee s @ l 
SETZ	  z ee t s 
SETZE	  z ee t s @ 
SETZEN	  z ee t s @ n 
SETZT	  z ee t s t 
SICH	  z ii cc 
SICHER	  z ii cc ei 
SICHERER	  z ii cc @ r ei 
SICHERHEIT	  z ii cc ei h ai t 
SICHERHEITSANFORDERUNGEN	  z ii cc ei h ai t z a n f oo r d @ r uu nn @ n 
SICHERHEITSLüCKEN	  z ii cc ei h ai t s   l y:   k e: n 
SICHERHEITSMäNGEL	  z ii cc ei h ai t s   m ee:   nn e: l 
SICHERHEITSMäNGELN	  z ii cc ei h ai t s   m ee:   nn ee l n 
SICHERHEITSSTANDARDS	  z ii cc ei h ai t s ss t a n d a r t s 
SICHERHEITSSYSTEM	  z ii cc ei h ai t s yy s t @ m 
SICHERT	  z ii cc @ r t 
SIE	  z i: 
SIEBEN	  z i: b @ n 
SIEBTE	  z i: b t @ 
SIEBTEN	  z i: b t @ n 
SIEHT	  z i: t 
SIGNAL	  z ii g n aa: l 
SIGNALE	  z ii g n aa: l @ 
SIGNATUR	  z ii g n a t u: r 
SIGNIEREN	  z ii g n i: r @ n 
SIGNIERT	  z ii g n i: r t 
SIGNIERUNG	  z ii g n i: r uu nn 
SIND	  z ii n t 
SINN	  z ii n 
SINNE	  z ii n @ 
SITTEN	  z ii t @ n 
SITZ	  z ii t s 
SITZE	  z ii t s @ 
SITZEN	  z ii t s @ n 
SITZT	  z ii t s t 
SO	  z o: 
SOFERN	  z o: f @ r n 
SOFORT	  z o: f oo r t 
SOFTWARE	  s oo f t v ee @ 
SOFTWARELIZENZ	  z oo f t v a r ee l i: t s ee n t s 
SOFTWARELIZENZEN	  z oo f t v a r ee l i: t s ee n t s @ n 
SOHN	  z o: n 
SOLCHE	  z oo l cc @ 
SOLDATEN	  z oo l d aa: t @ n 
SOLL	  z oo l 
SOLLEN	  z oo l @ n 
SOLLTE	  z oo l t @ 
SOMIT	  z o: m ii t 
SON	  z o: n 
SONDERN	  z oo n d @ r n 
SONDERQUADRAT	  z oo n d ei k v a d r aa: t 
SORGFALTSPFLICHTEN	  z oo r g f a l t s p f l ii cc t @ n 
SORGT	  z oo r k t 
SOWEIT	  z o: v ai t 
SOWIESO	  z o: v i: z o: 
SOZIALBINDUNG	  z o: t s i: a l b ii n d uu nn 
SOZIALE	  z o: t s i: aa: l @ 
SOZUSAGEN	  z o: t s u: z aa: g @ n 
SO_NE	  z o:   n e: 
SPALTE	  ss p a l t @ 
SPALTUNG	  ss p a l t uu nn 
SPAREN	  ss p aa: r @ n 
SPEICHERGEWEBE	  ss p ai cc ei g e: v e: b @ 
SPEZIALFETT	  ss p e: t s i: a l f ee t 
SPEZIELLE	  ss p e: t s j ee l @ 
SPEZIELLES	  ss p e: t s j ee l @ s 
SPEZIFISCHE	  ss p e: t s i: f ii ss @ 
SPIEGEL	  ss p i: g @ l 
SPIEGELE	  ss p i: g @ l @ 
SPIEGELN	  ss p i: g @ l n 
SPIEGLE	  ss p i: g l @ 
SPIELEN	  ss p i: l @ n 
SPIELT	  ss p i: l t 
SPITZE	  ss p ii t s @ 
SPRACHE	  ss p r aa: x @ 
SPRECHEN	  ss p r ee cc @ n 
SPRICH	  ss p r ii cc 
SPRICHT	  ss p r ii cc t 
SPäTER	  qq ee s   p ee:   t e: r 
SPäTEREN	  qq ee s   p ee:   t e: r @ n 
SPüRBAR	  qq ee s   p y:   qq r b aa: r 
SPüREN	  qq ee s   p y:   qq ee r @ n 
STAATLICHE	  ss t aa: t l ii cc @ 
STAATSANWALTSCHAFT	  ss t aa: t z a n v a l t ss a f t 
STAATSGEWALT	  ss t aa: t s g e: v a l t 
STABIL	  ss t a b i: l 
STADT	  ss t a t 
STADTTEIL	  ss t a t ai l 
STADTTEILE	  ss t a t ai l @ 
STAMMEN	  ss t a m @ n 
STAMMES	  ss t a m @ s 
STANDARD	  ss t a n d a r t 
STANDARDS	  ss t a n d a r t s 
STANDORTEN	  ss t a n d oo r t @ n 
STANDPUNKTE	  ss t a n d p uu nn k t @ 
STANGE	  ss t a nn @ 
STARK	  ss t a r k 
STARKE	  ss t a r k @ 
STARKER	  ss t a r k ei 
STARTETE	  ss t a r t @ t @ 
STARTETEN	  ss t a r t @ t @ n 
STATISCHE	  ss t a t ii ss @ 
STATT	  ss t a t 
STATTFINDEN	  ss t a t f ii n d @ n 
STATTFINDET	  ss t a t f ii n d @ t 
STATTGEGEBEN	  ss t a t g e: g e: b @ n 
STATUS	  ss t a t uu s 
STECKEN	  ss t ee k @ n 
STEHEN	  ss t e: @ n 
STEHENDES	  ss t e: @ n d @ s 
STEHT	  ss t e: t 
STEIGT	  ss t ai k t 
STEIGUNGEN	  ss t ai g uu nn @ n 
STEIN	  ss t ai n 
STEINCHEN	  ss t ai n cc @ n 
STEINE	  ss t ai n @ 
STEINEN	  ss t ai n @ n 
STELLE	  ss t ee l @ 
STELLEN	  ss t ee l @ n 
STELLSCHRAUBE	  ss t ee l ss r au b @ 
STELLT	  ss t ee l t 
STERN	  ss t ee r n 
STETS	  ss t e: t s 
STEUERHINTERZIEHUNG	  ss t oy ei h ii n t ei t s i: uu nn 
STGB	  qq ee s t e: g e: b e: 
STIFT	  ss t ii f t 
STILLSCHWEIGEND	  ss t ii l ss v ai g @ n t 
STILLSCHWEIGENDEN	  ss t ii l ss v ai g @ n d @ n 
STRAFANWENDUNGSRECHT	  ss t r a f a n v ee n d uu nn s r ee cc t 
STRAFANZEIGE	  ss t r a f a n t s ai g @ 
STRAFBESTIMMUNG	  ss t r a f b ee s t ii m uu nn 
STRAFE	  ss t r aa: f @ 
STRAFFREI	  ss t r a f r ai 
STRAFGESETZBUCH	  ss t r a f g e: z ee t s b uu x 
STRAFRAHMEN	  ss t r a f r aa: m @ n 
STRAFRECHT	  ss t r a f r ee cc t 
STRAFRICHTER	  ss t r a f r ii cc t ei 
STRAFTAT	  ss t r a f t aa: t 
STRAFTATBESTAND	  ss t r a f t a t b ee s t a n t 
STRAFTATEN	  ss t r a f t aa: t @ n 
STRAFTäTER	  ss t r aa: f   t ee:   t e: r 
STRAFVERFOLGUNGSBEHöRDEN	  ss t r a f v ei f oo l g uu nn s b @   h ui:   qq r d @ n 
STRECKEN	  ss t r ee k @ n 
STREITBARE	  ss t r ai t b aa: r @ 
STREITEN	  ss t r ai t @ n 
STREITGEGENSTAND	  g e: g @ n g e: g @ n n s t a n t 
STRENG	  ss t r ee nn 
STREUSALZ	  ss t r oy z a l t s 
STROMVERSCHLüSSELUNG	  ss t r oo m v ei ss   l y:   s e: l uu nn 
STROMVERSORGUNG	  ss t r oo m v ei z oo r g uu nn 
STRUKTUREN	  ss t r uu k t u: r @ n 
STäDTE	  qq ee s   t ee:   t e: 
STöRT	  qq ee s   t ui:   qq ee r t e: 
STöRUNGEN	  qq ee s   t ui:   qq r uu nn @ n 
STüCK	  qq ee s   t y:   s e: k aa: 
STüRZE	  qq ee s   t y:   qq r t s e: 
STüTZT	  qq ee s   t y:   t e: t s ee t t e: 
SUBJEKTIVEN	  z uu b j ee k t i: v @ n 
SUBSTANZ	  z uu b s t a n t s 
SUCHE	  z u: x @ 
SUCHEN	  z u: x @ n 
SUKZESSIVE	  z uu k t s ee s i: v @ 
SUPERMARKT	  z u: p ei m a r k t 
SUPERREICHEN	  z u: p ee r r ai cc @ n 
SYMMETRISCHE	  z yy m ee t r ii ss @ 
SYMMETRISCHEN	  z yy m ee t r ii ss @ n 
SYNCHRON	  z yy n k r o: n 
SYNCHRONE	  z yy n k r o: n @ 
SYSTEM	  z ii s t ee m 
SYSTEME	  z ii s t ee m @ 
SYSTEMS	  z ii s t ee m s 
SZENARIO	  s t s e: n a r ii o: 
T	  t e: 
T'S	  t e: t s 
TAGEN	  t aa: g @ n 
TANGIERT	  t a nn i: r t 
TARIFVERHANDLUNGEN	  t a r ii f v ei h a n d l uu nn @ n 
TAT	  t aa: t 
TATBESTANDSMERKMALE	  t a t b ee s t a n d s m ei k m aa: l @ 
TATOPFER	  t a t oo p f ei 
TATORT	  t a t oo r t 
TATSACHE	  t a t z a x @ 
TATSäCHLICH	  t aa: t   z ee:   cc l ii cc 
TECHNIK	  t ee cc n i: k 
TECHNIKEN	  t ee cc n i: k @ n 
TECHNISCHE	  t ee cc n ii ss @ 
TECHNOLOGIE	  t ee cc n o: l o: g i: 
TECHNOLOGISCH	  t ee cc n o: l o: g ii ss 
TEIL	  t ai l 
TEILBARKEIT	  t ai l b a r k ai t 
TEILBAUSTEIN	  t ai l b au s t ai n 
TEILE	  t ai l @ 
TEILEN	  t ai l @ n 
TEILNEHMER	  t ai l n e: m ei 
TEILNEHMERS	  t ai l n e: m ei s 
TEILS	  t ai l s 
TEILT	  t ai l t 
TEIL_	  t ai l 
TELEFAX	  t e: l e: f aa: k s 
TELEFONANSCHLUSS	  t e: l e: f o: n a n ss l uu s 
TELEFONGESPRäCHE	  t e: l e: f oo n g ee s p   qq r ee:   cc e: 
TELEFONIEREN	  t e: l e: f o: n i: r @ n 
TELEFONNUMMER	  t e: l e: f oo n uu m ei 
TELEFONSOFTWARE	  t ee l ii f oo n s @ f t v ee @ 
TELEKOMMUNIKATIONSSTANDARD	  t e: l e: k oo m u: n i: k a t s ii o: n s ss t a n d a r t 
TESTZEITRAUMS	  t ee s t s ai t r au m s 
TEURER	  t oy r ei 
TEXT	  t ee k s t 
THEMA	  t e: m aa: 
THEORETISCH	  t e: o: r e: t ii ss 
THEORIEN	  t e: o: r i: @ n 
THOUSAND	  t u: z a n t 
THOUSAND0	  t u: z a n t   n uu l 
TIEFBAU	  t i: f b au 
TIEFER	  t i: f ei 
TIER	  t i: r 
TIERCHEN	  t i: r cc @ n 
TIERES	  t i: r @ s 
TOLERANZ	  t o: l e: r a n t s 
TOTALAUSFALL	  t o: t a l au s f a l 
TRADITIONELL	  t r a d i: t s ii o: n ee l 
TRADITIONELLE	  t r a d i: t s ii o: n ee l @ 
TRANSFORMIERT	  t r a n s f oo r m i: r t 
TRANSPORTIERT	  t r a n s p oo r t i: r t 
TRANSPORTRäDER	  t r a n s p oo r t   qq r ee:   d ee r 
TREFFEN	  t r ee f @ n 
TREPPE	  t r ee p @ 
TREPPENSTUFE	  t r ee p @ n s t u: f @ 
TRETEN	  t r e: t @ n 
TREU	  t r oy 
TRITT	  t r ii t 
TROCKEN	  t r oo k @ n 
TROCKENEN	  t r oo k @ n @ n 
TROPENHOLZ	  t r o: p @ n h oo l t s 
TRäGER	  t e:   qq r ee:   g e: r 
TRäGT	  t e:   qq r ee:   g e: t e: 
TUN	  t u: n 
TWO	  t u: 
TYPENZWANG	  t y: p @ n t s v a nn 
TYPISCHERWEISE	  t y: p ii ss ei v ai z @ 
T´S	  t e: t s 
TäTER	  t ee:   t e: r 
TäTIGKEIT	  t ee:   t ii cc k ai t 
TüR	  t y:   qq ee r 
U	  qq u: 
UHRZEIGERSINN	  qq u: r t s ai g ei z ii n 
UM	  qq uu m 
UMFANG	  uu m f a nn 
UMFELD	  uu m f ee l t 
UMGEBAUT	  qq uu m g @ b au t 
UMGEDREHTE	  qq uu m g @ d r e: t @ 
UMGEDREHTEN	  qq uu m g @ d r e: t @ n 
UMGEDREHTES	  qq uu m g @ d r e: t @ s 
UMGEHEN	  uu m g e: @ n 
UMGEKEHRTES	  qq uu m g @ k e: r t @ s 
UMGEKIPPTES	  qq uu m g @ k ii p t @ s 
UMRAHMT	  uu m qq r aa: m t 
UMSCHLIEßT	  uu m ss l i:   qq e: s   t e: 
UMSCHLOSSEN	  uu m ss l oo s @ n 
UMSCHRIEBEN	  uu m ss r i: b @ n 
UMSONST	  uu m z o: n s t 
UMSTRITTEN	  uu m ss t r ii t @ n 
UMWICKELT	  uu m v ii k @ l t 
UM_NEUNZIG_GRAD	  qq qq uu m   n oy n t s ii cc   g r aa: t 
UNABHäNGIGES	  qq qq uu n qq a p   h ee:   nn i: g @ s 
UNBEDINGT	  qq uu n b @ d ii nn t 
UNBEFRISTET	  qq uu n b @ f r ii s t @ t 
UNBEGRENZTE	  qq uu n b @ g r ee n t s t @ 
UNBEKANNT	  qq uu n b @ k a n t 
UNBETEILIGTEN	  qq uu n b @ t ai l ii cc t @ n 
UND	  qq uu n t 
UND_DABEI	  qq uu n t   d a b ai 
UND__	  qq uu n t 
UNGESICHERTE	  qq uu n g @ z ii cc @ r t @ 
UNMITTELBAR	  qq uu n m ii t @ l b aa: r 
UNMITTELBARE	  qq uu n m ii t @ l b aa: r @ 
UNMöGLICHKEIT	  qq uu n   m ui:   g l ii cc k ai t 
UNPROBLEMATISCH	  qq uu n p r o: b l e: m aa: t ii ss 
UNPRäZISER	  qq uu n p   qq r ee:   t s i: z ei 
UNS	  qq uu n s 
UNSERER	  qq uu n z @ r ei 
UNSICHERER	  qq uu n z ii cc @ r ei 
UNTEN	  qq uu n t @ n 
UNTER	  qq uu n t ei 
UNTERBAUCH	  qq uu n t ei b au x 
UNTERBRECHEN	  qq uu n t ei b r ee cc @ n 
UNTERDRüCKT	  qq uu n t e: r t   qq r y:   s e: k aa: t e: 
UNTERE	  qq uu n t ei qq e: 
UNTEREINANDER	  qq uu n t ei qq ai n a n d ei 
UNTEREM	  qq uu n t ei qq e: m 
UNTEREN	  qq uu n t ei @ n 
UNTERHALB	  qq uu n t ei h a l p 
UNTERKANTE	  qq uu n t ei k a n t @ 
UNTERLIEGEN	  qq uu n t ei l i: g @ n 
UNTERROHRS	  qq uu n t ei qq r o: r s 
UNTERSCHEIDET	  qq uu n t ei ss ai d @ t 
UNTERSCHIEDLICH	  qq uu n t ei ss i: d l ii cc 
UNTERSCHIEDLICHE	  qq uu n t ei ss i: d l ii cc @ 
UNTERSCHIEDLICHEN	  qq uu n t ei ss i: d l ii cc @ n 
UNTERSCHLAGEN	  qq uu n t ei ss l aa: g @ n 
UNTERSCHRIEBEN	  qq uu n t ei ss r i: b @ n 
UNTERSCHRIFT	  qq uu n t ei ss r ii f t 
UNTERSEITE	  qq uu n t ei z ai t @ 
UNTERSTE	  qq uu n t ei s t @ 
UNTERSTEN	  qq uu n t ei s t @ n 
UNTERSTüTZT	  qq uu n t ei s   t y:   t e: t s ee t t e: 
UNTERSTüTZUNG	  qq uu n t ei s   t y:   t s uu nn 
UNTERSUCHEN	  qq uu n t ei z u: x @ n 
UNTERSUCHT	  qq uu n t ei z u: x t 
UNTERTEIL	  qq uu n t ei t ai l 
UNTERTEILT	  qq uu n t ei t ai l t 
UNVERSCHLüSSELTE	  qq uu n v ee r ss   l y:   s ee l t @ 
UNVERZICHTBAR	  qq uu n f ee r t s ii cc t b aa: r 
UNWAHRSCHEINLICH	  qq uu n v aa: r ss ai n l ii cc 
UNWIRKSAM	  qq uu n v ii r k z aa: m 
UNZULäSSIGER	  qq qq uu n t s u:   l ee:   s i: g ei 
UNZUMUTBARKEIT	  qq uu n t s u: m uu t b a r k ai t 
UNZUREICHEND	  qq uu n t s u: qq r ai cc @ n t 
UNüBERSEHBAR	  qq u:   n y:   b ee r z e: b aa: r 
URSPRUNG	  qq uu r s p r uu nn 
URSPRüNGLICHE	  qq uu r s p   qq r y:   nn l ii cc @ 
URTEIL	  qq uu r t ai l 
USA	  qq u: z aa: 
VARIANTEN	  v a r i: a n t @ n 
VATER	  v aa: t ei 
VERANKERT	  f ee r qq a n k ee r t 
VERANLASST	  f ee r qq a n l a s t 
VERANTWORTLICHKEIT	  f ee r qq a n t v oo r t l ii cc k ai t 
VERBAUT	  f ee r b au t 
VERBINDEN	  f ee r b ii n d @ n 
VERBINDUNG	  f ee r b ii n d uu nn 
VERBLASST	  f ee r b l a s t 
VERBOT	  f ee r b o: t 
VERBOTEN	  f ee r b o: t @ n 
VERBOTSVORSCHRIFT	  f ee r b oo t s v oo r ss r ii f t 
VERBRECHEN	  f ee r b r ee cc @ n 
VERBREITET	  f ee r b r ai t @ t 
VERBREITETEN	  f ee r b r ai t @ t @ n 
VERBREITUNG	  f ee r b r ai t uu nn 
VERBRENNUNG	  f ee r b r ee n uu nn 
VERBRENNUNGSGEFAHR	  f ee r b r ee n uu nn s g @ f aa: r 
VERBUNDEN	  f ee r b uu n d @ n 
VERDACHTSANZEIGE	  f ee r d a x t z a n t s ai g @ 
VERDOPPELUNG	  f ee r d oo p @ l uu nn 
VERDREHT	  f ee r d r e: t 
VEREINBART	  f ee r qq ai n b a r t 
VEREINBARUNG	  f ee r qq ai n b a r uu nn 
VEREINBARUNGEN	  f ee r qq ai n b a r uu nn @ n 
VEREINT	  f ee r qq ai n t 
VERFAHREN	  f ee r f aa: r @ n 
VERFAHRENSRECHT	  f ee r f aa: r @ n s r ee cc t 
VERFASSUNG	  f ee r f a s uu nn 
VERFASSUNGSBESCHWERDE	  f ee r f a s uu nn s b @ ss v e: r d @ 
VERFASSUNGSBESCHWERDEN	  f ee r f a s uu nn s b @ ss v e: r d @ n 
VERFASSUNGSKONFORM	  f ee r f a s uu nn s k oo n f oo r m 
VERFASSUNGSMäßIGKEIT	  f ee r f a s uu nn s   m ee: s   qq ii cc k ai t 
VERFASSUNGSORGAN	  f ee r f a s uu nn s qq oo r g aa: n 
VERFASSUNGSORGANE	  f ee r f a s uu nn s qq oo r g aa: n @ 
VERFASSUNGSWIDRIG	  f ee r f a s uu nn s v ii d r ii cc 
VERFOLGEN	  f ee r f oo l g @ n 
VERFOLGT	  f ee r f oo l k t 
VERFüGBAR	  v e: r   f y:   g b aa: r 
VERFüGBAREN	  v e: r   f y:   g b aa: r @ n 
VERFüGBARKEIT	  v e: r   f y:   g b a r k ai t 
VERFüGUNG	  v e: r   f y:   g uu nn 
VERGEBEN	  f ee r g e: b @ n 
VERGEGENWäRTIGEN	  f ee r g e: g @ n   v ee:   qq r t i: g @ n 
VERGEHEN	  f ee r g e: @ n 
VERGLEICHEN	  f ee r g l ai cc @ n 
VERGLEICHSWERTE	  f ee r g l ai cc s v ee r t @ 
VERHINDERTE	  f ee r h ii n d @ r t @ 
VERHäLT	  v e: r   h ee:   qq ee l t e: 
VERHäLTNIS	  v e: r   h ee:   l t n i: s 
VERHäNGT	  v e: r   h ee:   qq ee n g e: t e: 
VERIFIZIEREN	  f ee r qq i: f i: t s i: r @ n 
VERJäHRUNG	  v e: r   j ee:   h r uu nn 
VERKABELUNG	  f ee r k a b @ l uu nn 
VERKANNT	  f ee r k a n t 
VERKEHRT	  f ee r k e: r t 
VERKäUFER	  v e: r   k ee:   qq u: f ei 
VERKüNDET	  v e: r   k y:   n d e: t 
VERKüRZT	  v e: r   k y:   qq ee r t s ee t t e: 
VERKüRZUNG	  v e: r   k y:   qq r t s uu nn 
VERLANGEN	  f ee r l a nn @ n 
VERLANGT	  f ee r l a nn t 
VERLAUFEN	  f ee r l au f @ n 
VERLETZT	  f ee r l ee t s t 
VERLETZTE	  f ee r l ee t s t @ 
VERLETZUNG	  f ee r l ee t s uu nn 
VERLIEREN	  f ee r l i: r @ n 
VERLIERST	  f ee r l i: r s t 
VERLUST	  f ee r l uu s t 
VERLäNGERST	  v e: r   l ee:   nn e: r s t 
VERLäNGERT	  v e: r   l ee:   nn ee r t 
VERLäNGERTEN	  v e: r   l ee:   nn ee r t @ n 
VERMEIDEN	  f ee r m ai d @ n 
VERMEINTLICHEN	  f ee r m ai n t l ii cc @ n 
VERMESSEN	  f ee r m ee s @ n 
VERMIEDEN	  f ee r m i: d @ n 
VERMIETERS	  f ee r m i: t ei s 
VERMISSE	  f ee r m ii s @ 
VERMITTLUNGSSTELLE	  f ee r m ii t l uu nn s ss t ee l @ 
VERMUTLICH	  f ee r m u: t l ii cc 
VERMöGEN	  v e: r   m ui:   g e: n 
VERMöGENSVERTEILUNG	  v e: r   m ui:   g ee n s v ei t ai l uu nn 
VERNEINEN	  f ee r n ai n @ n 
VERNETZUNG	  f ee r n ee t s uu nn 
VERNüNFTIGER	  v e: r   n y:   n f t i: g ei 
VERPFLICHTET	  f ee r p f l ii cc t @ t 
VERPFLICHTUNGSKLAGE	  f ee r p f l ii cc t uu nn s k l aa: g @ 
VERRINGERT	  f ee r qq r ii nn @ r t 
VERSCHIEDENE	  f ee r ss i: d @ n @ 
VERSCHIEDENEN	  f ee r ss i: d @ n @ n 
VERSCHLEIERT	  f ee r ss l ai ei t 
VERSCHLEIERUNG	  f ee r ss l ai @ r uu nn 
VERSCHLüSSELN	  v ee r ss   l y:   s ee l n 
VERSCHLüSSELT	  v ee r ss   l y:   s ee l t 
VERSCHLüSSELUNG	  v ee r ss   l y:   s e: l uu nn 
VERSCHMUTZTE	  f ee r ss m uu t s t @ 
VERSCHOBEN	  f ee r ss o: b @ n 
VERSCHULDEN	  f ee r ss uu l d @ n 
VERSCHULDENSFäHIG	  f ee r ss uu l d @ n s   f ee:   h i: k 
VERSCHULDENSFäHIGE	  f ee r ss uu l d @ n s   f ee:   h i: g @ 
VERSCHULDENSFäHIGEN	  f ee r ss uu l d @ n s   f ee:   h i: g @ n 
VERSCHULDENSUNFäHIGE	  f ee r ss uu l d @ n z u: n   f ee:   h i: g @ 
VERSEHEN	  f ee r z e: @ n 
VERSENDET	  f ee r z ee n d @ t 
VERSETZT	  f ee r z ee t s t 
VERSION	  f ee r z ii o: n 
VERSIONEN	  f ee r z ii o: n @ n 
VERSIONSNUMMER	  f ee r z ii o: n s n uu m ei 
VERSORGT	  f ee r z oo r k t 
VERSTANDEN	  f ee r ss t a n d @ n 
VERSTECK	  f ee r ss t ee k 
VERSTEHEN	  f ee r ss t e: @ n 
VERSTEHST	  f ee r ss t e: s t 
VERSTEHT	  f ee r ss t e: t 
VERSTOßEN	  v ee r ss t   qq o: s   qq e: n 
VERSTäRKT	  v e: r s   t ee:   qq ee r k aa: t e: 
VERSTößT	  v e: r s   t ui: s   t e: 
VERSUCHT	  f ee r z u: x t 
VERSUCHTE	  f ee r z u: x t @ 
VERTEILUNG	  f ee r t ai l uu nn 
VERTIKAL	  v ee r t i: k aa: l 
VERTRAG	  f ee r t r aa: k 
VERTRAGES	  f ee r t r aa: g @ s 
VERTRAGLICHE	  f ee r t r aa: g l ii cc @ 
VERTRAGLICHEN	  f ee r t r aa: g l ii cc @ n 
VERTRAGSAUSLEGUNG	  f ee r t r a g z au s l e: g uu nn 
VERTRAGSCHLIEßENDEN	  f ee r t r a g ss l i:   qq e: s   qq ee n d @ n 
VERTRAGSFREIHEIT	  f ee r t r a g s f r ai h ai t 
VERTRAGSGEGENSTAND	  f ee r g e: g @ n g e: g @ n ss t a n t 
VERTRAGSGLäUBIGER	  f ee r t r a g s k   l ee:   qq u: b ii g ei 
VERTRAGSGLäUBIGERS	  f ee r t r a g s k   l ee:   qq u: b i: g ei s 
VERTRAGSPARTEIEN	  f ee r t r a g s p a r t ai @ n 
VERTRAGSPARTNER	  f ee r t r a g s p a r t n ei 
VERTRAGSSCHLUSSES	  f ee r t r a g s cc l uu s @ s 
VERTRAGSTYPEN	  f ee r t r a g s t y: p @ n 
VERTRAGSVERHANDLUNGEN	  f ee r t r a g s v ei h a n d l uu nn @ n 
VERTRAGSVERHäLTNIS	  f ee r t r a g s v ei   h ee:   l t n i: s 
VERTRETEN	  f ee r t r e: t @ n 
VERTRETER	  f ee r t r e: t ei 
VERTRIEBEN	  f ee r t r i: b @ n 
VERTRäGE	  v ee r t   qq r ee:   g e: 
VERURSACHEN	  f ee r qq uu r z a x @ n 
VERURSACHT	  f ee r qq uu r z a x t 
VERURTEILTE	  f ee r qq uu r t ai l t @ 
VERURTEILTEN	  f ee r qq uu r t ai l t @ n 
VERWALTUNGSAKT	  f ee r v a l t uu nn s qq a k t 
VERWALTUNGSAKTES	  f ee r v a l t uu nn s qq a k t @ s 
VERWECHSLUNGSGEFAHR	  f ee r v ee cc s l uu nn s g @ f aa: r 
VERWEIGERT	  f ee r v ai g @ r t 
VERWENDEN	  f ee r v ee n d @ n 
VERWENDET	  f ee r v ee n d @ t 
VERWENDUNG	  f ee r v ee n d uu nn 
VERWENDUNGEN	  f ee r v ee n d uu nn @ n 
VERWIRKUNG	  f ee r v ii r k uu nn 
VERWIRKUNGSVERFAHREN	  f ee r v ii r k uu nn s v ei f aa: r @ n 
VERZEICHNISSE	  f ee r t s ai cc n ii s @ 
VERZöGERUNG	  v e: r   t s ui:   g @ qq r uu nn 
VERäNDERBAR	  v e:   qq r ee:   n d e: r b aa: r 
VERäNDERT	  v e:   qq r ee:   n d ee r t 
VERöFFENTLICHEN	  v e:   qq r ui:   f ee n t l ii cc @ n 
VERöFFENTLICHT	  v e:   qq r ui:   f ee n t l ii cc t 
VERöLTE	  v e:   qq r ui:   l t e: 
VIDEO	  v i: d e: o: 
VIDEOKONFERENZEN	  v i: d e: o: k oo n f e: r ee n t s @ n 
VIEL	  f i: l 
VIELE	  f i: l @ 
VIELEN	  f i: l @ n 
VIELES	  f i: l @ s 
VIELLEICHT	  f i: l l ai cc t 
VIELSEITIGEN	  f i: l z ai t ii g @ n 
VIER	  f i: r 
VIERECK	  f i: r ee k 
VIERERKETTE	  f i: r ei k ee t @ 
VIERTE	  f i: r t @ 
VIERTEILIGEN	  f i: r t ai l ii g @ n 
VIERTER	  f i: r t ei 
VIRTUELLER	  v ii r t u: ee l ei 
VOGEL	  v o: g @ l 
VOLLE	  f oo l @ 
VOLLENDET	  f oo l qq ee n d @ t 
VOLLKOMMEN	  f oo l k oo m @ n 
VOLLKOMMENE	  f oo l k oo m @ n @ 
VOLLSTRECKUNG	  f oo l s t r ee k uu nn 
VOLLSTäNDIG	  f oo l s   t ee:   n d i: k 
VOLLZOGEN	  f oo l t s o: g @ n 
VOLLZUGSAKT	  f oo l t s u: g z a k t 
VOM	  f oo m 
VON	  f oo n 
VOR	  f oo r 
VORAUSSETZUNG	  f o: r au s z ee t s uu nn 
VORAUSSETZUNGEN	  f o: r au s z ee t s uu nn @ n 
VORBEHALT	  f o: r b @ h a l t 
VORDERBEIN	  f oo r d @ r b ai n 
VORDERBEINS	  f oo r d @ r b ai n s 
VORDERE	  f oo r d @ r @ 
VORDEREN	  f oo r d @ r @ n 
VORDERFUß	  f oo r d @ r f   qq u: s 
VORGANG	  f o: r g a nn 
VORGEGANGEN	  f o: r g @ g a nn @ n 
VORGEGEBENEN	  f o: r g @ g e: b @ n @ n 
VORGEHENSWEISE	  f o: r g e: @ n s v ai z @ 
VORGENOMMEN	  f o: r g @ n oo m @ n 
VORGESCHRIEBEN	  f o: r g @ ss r i: b @ n 
VORGESEHEN	  f o: r g @ z e: @ n 
VORGESEHENE	  f o: r g @ z e: @ n @ 
VORHANDEN	  f o: r h a n d @ n 
VORHANDENE	  f o: r h a n d @ n @ 
VORHANDENEN	  f o: r h a n d @ n @ n 
VORHER	  f o: r h e: r 
VORLIEGT	  f o: r l i: k t 
VORNAHME	  f o: r n aa: m @ 
VORNE	  v oo r n @ 
VORNHEREIN	  f o: r n h e: r ai n 
VORRANG	  f o: r qq r a nn 
VORSICHTIG	  f o: r z ii cc t ii cc 
VORSTELLEN	  f o: r ss t ee l @ n 
VORSTELLT	  f o: r ss t ee l t 
VORTEILE	  f o: r t ai l @ 
VORTEILHAFTER	  f o: r t ai l h a f t ei 
VORTRAG	  f o: r t r aa: k 
VORVERTRAGLICHES	  f o: r f ee r t r aa: g l ii cc @ s 
VöLKERGEWOHNHEITSRECHT	  v ui:   l k ee r g e: v o: n h ai t s r ee cc t 
VöLKERRECHT	  v ui:   l k ee r ee cc t 
VöLKERRECHTSWIDRIG	  v ui:   l k ee r ee cc t s v ii d r ii cc 
W	  v e: 
W-	  v e: 
WAAGERECHT	  v aa: g e: r ee cc t 
WAHRE	  v aa: r @ 
WAHRHEIT	  v aa: r h ai t 
WAHRSCHEINLICH	  v aa: r ss ai n l ii cc 
WAND	  v a n t 
WANN	  v a n 
WAR	  v aa: r 
WAREN	  v aa: r @ n 
WARTESCHLEIFE	  v a r t ee ss l ai f @ 
WARTET	  v a r t @ t 
WARTETE	  v a r t @ t @ 
WARUM	  v aa: r uu m 
WAS	  v a s 
WASSERFäLLE	  v a s ei   f ee:   l e: 
WASSERHAHN	  v a s @ r h aa: n 
WEBSERVER	  v ee b z @ r v ei 
WEDER	  v e: d ei 
WEG	  v e: k 
WEGEN	  v e: g @ n 
WEGLAUFEN	  v e: k l au f @ n 
WEHRPFLICHT	  v e: r p f l ii cc t 
WEIL	  v ai l 
WEILE	  v ai l @ 
WEIMAR	  v ai m aa: r 
WEISE	  v ai z @ 
WEIST	  v ai s t 
WEIT	  v ai t 
WEITER	  v ai t ei 
WEITERE	  v ai t ei @ 
WEITEREN	  v ai t ei @ n 
WEITERENTWICKELN	  v ai t @ r qq ee n t v ii k @ l n 
WEITERGEHEN	  v ai t @ r g e: @ n 
WEITERGELEITET	  v ai t @ r g @ l ai t @ t 
WEITERHIN	  v ai t @ r h ii n 
WEITERLEITUNG	  v ai t @ r l ai t qq uu nn 
WEITERVERäUßERT	  v ai t @ r v @   qq r ee:   qq u: s   qq ee r t 
WEITESTEN	  v ai t @ s t @ n 
WEIß	  v e:   qq i: s 
WEIßE	  v e:   qq i: s   qq e: 
WEIßEN	  v e:   qq i: s   qq e: n 
WEIßER	  v e:   qq i: s   qq ee r 
WEIßES	  v e:   qq i: s   qq ee z 
WELCHE	  v ee l cc @ 
WELCHEM	  v ee l cc @ m 
WELCHEN	  v e: l cc @ n 
WELCHER	  v ee l cc ei 
WELCHES	  v ee l cc @ s 
WELTKRIEG	  v ee l t k r i: k 
WELTKRIEGEN	  v ee l t k r i: g @ n 
WENDEN	  v ee n d @ n 
WENIG	  v e: n ii cc 
WENN	  v ee n 
WER	  v e: r 
WERDE	  v ee r d @ 
WERDEN	  v ee r d @ n 
WERKSTATT	  v ee r k s t a t 
WERKZEUG	  v ee r k t s oy k 
WERT	  v ee r t 
WERTE	  v ee r t @ 
WERTES	  v ee r t @ s 
WERTSICHERUNGSKLAUSEL	  v ee r t s ii cc e: r uu nn s k l au z @ l 
WESENTLICHEN	  v e: z @ n t l ii cc @ n 
WETTBEWERBSVORTEIL	  v ee t b e: v ei b s v oo r t ai l 
WETTER	  v ee t ei 
WICHTIG	  v ii cc t ii cc 
WICHTIGE	  v ii cc t ii g @ 
WICHTIGER	  v ii cc t ii g ei 
WIDERLEGT	  v i: d ei l e: k t 
WIDERSPRUCH	  v i: d ei s p r uu x 
WIE	  v i: 
WIE'N	  v i: n 
WIEDER	  v i: d ei 
WIEDERHOLEN	  v i: d ei h o: l @ n 
WIEDERHOLT	  v i: d ei h oo l t 
WIEN	  v i: n 
WILLENSBILDUNG	  v ii l @ n s b ii l d uu nn 
WILLENSERKLäRUNG	  v ii l ee n z @ r k   l ee:   qq r uu nn 
WILLST	  v ii l s t 
WILLY	  v ii l ii 
WINKEL	  v ii n k @ l 
WINKLIGE	  v ii nn k l ii g @ 
WINTER	  v ii n t ei 
WIR	  v i: r 
WIRD	  v ii r t 
WIRELESS	  v i: r @ l ee s 
WIRKEN	  v ii r k @ n 
WIRKLICH	  v ii r k l ii cc 
WIRKSAM	  v ii r k z aa: m 
WIRKSAMKEIT	  v ii r k z aa: m k ai t 
WIRKT	  v ii r k t 
WIRKUNG	  v ii r k uu nn 
WIRTSCHAFT	  v ii r t ss a f t 
WIRTSCHAFTLICHEN	  v ii r t ss a f t l ii cc @ n 
WIRTSCHAFTSMODELL	  v ii r t ss a f t s m o: d ee l 
WISSENSCHAFT	  v ii s @ n ss a f t 
WISSENSCHAFTEN	  v ii s @ n ss a f t @ n 
WISSENSCHAFTLICHE	  v ii s @ n ss a f t l ii cc @ 
WITTERUNGSEINFLüSSE	  v ii t e: r uu nn s qq ai n f   l y:   s e: 
WLAN	  v l aa: n 
WO	  v o: 
WOBEI	  v o: b ai 
WODURCH	  v o: d uu r cc 
WOHL	  v o: l 
WOHLSTAND	  v o: l ss t a n t 
WOLLEN	  v oo l @ n 
WOLLTE	  v oo l t @ 
WOLLTEN	  v oo l t @ n 
WORDEN	  v oo r d @ n 
WORDPRESS	  v oo r d p r @ s 
WORTEN	  v oo r t @ n 
WOVON	  v o: v o: n 
WUCHS	  v uu k s 
WURDE	  v uu r d @ 
WURDEN	  v uu r d @ n 
WURM	  v uu r m 
WURSCHT	  v uu r ss t 
WäCHST	  v ee:   s e: h aa: ee s t e: 
WäHLENDEN	  v ee:   h l ee n d @ n 
WäHREND	  v ee:   h r ee n t 
WäRE	  v ee:   qq r e: 
WüRDE	  v y:   qq r d e: 
WüRFEL	  v y:   qq r f e: l 
WüRFELS	  v y:   qq r f e: l s 
Z	  t s ee t 
ZAHL	  t s aa: l 
ZAHLEN	  t s aa: l @ n 
ZAHLREICHE	  t s aa: l r ai cc @ 
ZAHLREICHEN	  t s aa: l r ai cc @ n 
ZAHNKRANZSEITE	  t s aa: nn k r a n t s z ai t @ 
ZEICHEN	  t s ai cc @ n 
ZEIGEN	  t s ai g @ n 
ZEIGT	  t s ai k t 
ZEIT	  t s ai t 
ZEITEINHEIT	  t s ai t qq ai n h ai t 
ZEITLICH	  t s ai t l ii cc 
ZEITPUNKT	  t s ai t p uu nn k t 
ZEITRAUM	  t s ai t qq r au m 
ZEITWEISE	  t s ai t v ai z @ 
ZELLAUFBAU	  t s ee l au f b au 
ZERLEGEN	  t s ee r l e: g @ n 
ZERLEGT	  t s ee r l e: k t 
ZERTIFIZIERT	  t s ee r t i: f i: t s i: r t 
ZESSION	  t s ee s j o: n 
ZETTS	  t s ee t s 
ZIEHEN	  t s i: @ n 
ZIEHT	  t s i: t 
ZIEL	  t s i: l 
ZIELE	  t s i: l @ 
ZIELFIGUR	  t s i: l f i: g u: r 
ZIELOBJEKT	  t s i: l qq oo p j ee k t 
ZIEMLICH	  t s i: m l ii cc 
ZU	  t s u: 
ZUEINANDER	  t s y: i: n a n d ei 
ZUERST	  t s u: ee r s t 
ZUFALL	  t s u: f a l 
ZUFäLLIGE	  qq t s u:   f ee:   l i: g @ 
ZUFäLLIGERWEISE	  qq t s u:   f ee:   l i: g ei v ai z @ 
ZUGANG	  t s u: g a nn 
ZUGEFüGT	  t s u: g e:   f y:   g e: t e: 
ZUGEORDNET	  t s u: g @ qq oo r d n @ t 
ZUGERECHNET	  t s u: g @ qq r ee cc n @ t 
ZUGEWIESEN	  t s u: g @ v i: z @ n 
ZUGREIFEN	  t s u: g r ai f @ n 
ZUGRIFF	  t s u: g r ii f 
ZUGäNGLICH	  qq t s u:   g ee:   nn l ii cc 
ZUKUNFT	  t s u: k uu n f t 
ZUKUNFTSPROGNOSE	  t s u: k uu n f t s p r oo g n o: z @ 
ZULASTEN	  t s u: l a s t @ n 
ZUM	  t s uu m 
ZUNEHMEND	  t s u: n e: m @ n t 
ZUNäCHST	  qq t s u:   n ee:   s e: h aa: ee s t e: 
ZUORDNEN	  t s u: oo r d n @ n 
ZUR	  t s u: r 
ZURüCK	  qq t s u:   qq r y:   s e: k aa: 
ZURüCKBEHALTUNGSRECHT	  qq t s u:   qq r y:   k b e: a l t uu nn s r ee cc t 
ZURüCKGENOMMEN	  qq t s u:   qq r y:   k g e: n oo m @ n 
ZUSAMMEN	  t s u: z a m @ n 
ZUSAMMENFASSUNG	  t s u: z a m @ n f a s uu nn 
ZUSAMMENGEARBEITET	  t s u: z a m @ n g e: a r b ai t @ t 
ZUSAMMENGESCHLOSSEN	  t s u: z a m @ n g ee ss l oo s @ n 
ZUSAMMENHANG	  t s u: z a m @ n h a nn 
ZUSAMMENTRIFFT	  t s u: z a m @ n t r ii f t 
ZUSTAND	  t s u: ss t a n t 
ZUSTANDEGEKOMMEN	  t s u: ss t a n d e: g e: k oo m @ n 
ZUSTIMMUNGSGESETZ	  t s u: ss t ii m uu nn s g @ z ee t s 
ZUSTäNDIG	  t s uu s   t ee:   n d i: k 
ZUSTäNDIGKEIT	  t s uu s   t ee:   n d ii cc k ai t 
ZUSäTZLICHE	  qq t s u:   z ee:   t s l ii cc @ 
ZUSäTZLICHEN	  qq t s u:   z ee:   t s l ii cc @ n 
ZUWEISUNG	  t s u: v ai z uu nn 
ZUZUMUTEN	  t s u: t s u: m u: t @ n 
ZWAR	  t s v aa: r 
ZWEI	  t s v ai 
ZWEIERRIEGEL	  t s v ai ee r r i: g @ l 
ZWEIERRIEGELS	  t s v ai ee r r i: g @ l s 
ZWEIFEL	  t s v ai f @ l 
ZWEIGE	  t s v ai g @ 
ZWEIMAL	  t s v ai m aa: l 
ZWEITE	  t s v ai t @ 
ZWEITEILEN	  t s v ai t ai l @ n 
ZWEITEN	  t s v ai t @ n 
ZWEITER	  t s v ai t ei 
ZWEITE_TEIL	  t s v ai t @   t ai l 
ZWEITGRößTE	  t s v ai t k   qq r ui: s   t e: 
ZWEITHöCHSTEN	  t s v ai t   h ui:   s e: h s t e: n 
ZWISCHEN	  t s v ii ss @ n 
ZäHLT	  t s ee:   h aa: ee l t e: 
_BAD	  b aa: t 
_GRüNE	  g e:   qq r y:   n e: 
ÄHM	  qq e: m 
ÄHNLICHES	  qq e: n l ii cc @ s 
ÄNDERUNGEN	  qq ee n d @ r uu nn @ n 
ÄSTE	  qq ee s t @ 
ÄUßERE	  qq ee:   qq u: s   qq ee r qq e: 
ÖFFNUNG   qq ui: f n u: n
ÖL	  qq ui: l 
ÖLEN	  qq ui: l @ n 
ÜBER	  qq yy b ei 
ÜBERGABE	  qq y: b ei g aa: b @ 
ÜBERGANG	  qq y: b ei g a nn 
ÜBERPRüFUNG	  qq y: b @ r p   qq r y:   f uu nn 
ÜBERSCHNEIDUNGSBEREICH	  qq y: b ei ss n ai d uu nn s b @ r ai cc 
ÜBERTRAGUNG	  qq y: b ei t r a g uu nn 
ÜBERTRAGUNGSRATEN	  qq y: b ei t r a g uu nn s r aa: t @ n 
ä	  qq ee: 
äH	  qq ee:   h aa: 
äHM	  qq ee:   h @ m 
äLTER	  qq ee:   l t e: r 
äLTERE	  qq ee:   l t e: r @ 
äLTEREN	  qq ee:   l t e: r @ n 
äLTESTEN	  qq ee:   l t ee s t @ n 
äUßERE	  qq ee:   qq u: s   qq ee r qq e: 
äUßERST	  qq ee:   qq u: s   qq e: r s t 
öFFENTLICHE	  qq ui:   f ee n t l ii cc @ 
öFFENTLICHEN	  qq ui:   f ee n t l ii cc @ n 
öFFNEN	  qq ui:   f n e: n 
öKONOMISCHE	  qq ui:   k oo n o: m ii ss @ 
öLEN	  qq ui:   l e: n 
üBER	  qq y:   b e: r 
üBEREINANDER	  qq y:   b @ qq r qq ai n a n d ei 
üBERFLüSSIG	  qq y:   b ee r f   l y:   s i: k 
üBERGEGANGEN	  qq y:   b ee r g e: g a nn @ n 
üBERHALB	  qq y:   b ee r h a l p 
üBERLASSEN	  qq y:   b ee r l a s @ n 
üBERLASTET	  qq y:   b ee r l a s t @ t 
üBERNOMMEN	  qq y:   b ee r n oo m @ n 
üBERPRüFEN	  qq y:   b ee r p   qq r y:   f e: n 
üBERPRüFT	  qq y:   b ee r p   qq r y:   qq ee f t e: 
üBERSCHRITTEN	  qq y:   b ee r ss r ii t @ n 
üBERTRAGEN	  qq y:   b ee r t r aa: g @ n 
üBERWIEGEND	  qq y:   b ee r v i: g @ n t 
üBERWUNDEN	  qq y:   b ee r v uu n d @ n 
üBERZEUGT	  qq y:   b ee r t s oy k t 
üBLE	  qq y:   b l e: 
üBLICHERWEISE	  qq y:   b l ii cc ei v ai z @ 
üBRIG	  qq y:   b r i: k 
üBRIGEN	  qq y:   b r i: g @ n 
üBTE	  qq y:   b t e: 
